,Year,Month,Day,HomeTeam,AwayTeam,HomeScore,AwayScore,Tournament,Location,RatingTeam1,RatingTeam2,MatchName,Result,HigherRating,LowerRating,NewResult,RatingTotal,RatingDifferenceAbsolute,RatingDifferenceRelative
55,2016,3,24,Bolivia,Colombia,2,3,World Cup qualifier,,1616,1962,Bolivia-Colombia,2-3,1962,1616,3-2,3578,346,1.2141089108910892
56,2016,3,24,Chile,Argentina,1,2,World Cup qualifier,,1953,2046,Chile-Argentina,1-2,2046,1953,2-1,3999,93,1.0476190476190477
62,2016,3,24,Ecuador,Paraguay,2,2,World Cup qualifier,,1901,1741,Ecuador-Paraguay,2-2,1901,1741,2-2,3642,160,1.0919012062033313
74,2016,3,24,Peru,Venezuela,2,2,World Cup qualifier,,1774,1626,Peru-Venezuela,2-2,1774,1626,2-2,3400,148,1.0910209102091022
89,2016,3,25,Brazil,Uruguay,2,2,World Cup qualifier,,2028,1957,Brazil-Uruguay,2-2,2028,1957,2-2,3985,71,1.0362800204394482
103,2016,3,25,Nigeria,Egypt,1,1,African Nations Cup qualifier,,1630,1624,Nigeria-Egypt,1-1,1630,1624,1-1,3254,6,1.0036945812807883
149,2016,3,29,Argentina,Bolivia,2,0,World Cup qualifier,,2049,1613,Argentina-Bolivia,2-0,2049,1613,2-0,3662,436,1.2703037817730936
153,2016,3,29,Colombia,Ecuador,3,1,World Cup qualifier,,1979,1884,Colombia-Ecuador,3-1,1979,1884,3-1,3863,95,1.0504246284501062
157,2016,3,29,Egypt,Nigeria,1,0,African Nations Cup qualifier,,1639,1615,Egypt-Nigeria,1-0,1639,1615,1-0,3254,24,1.014860681114551
190,2016,3,29,Paraguay,Brazil,2,2,World Cup qualifier,,1751,2018,Paraguay-Brazil,2-2,2018,1751,2-2,3769,267,1.1524842946887492
207,2016,3,29,Uruguay,Peru,1,0,World Cup qualifier,,1964,1767,Uruguay-Peru,1-0,1964,1767,1-0,3731,197,1.1114883984153934
211,2016,3,29,Venezuela,Chile,1,3,World Cup qualifier,,1611,1968,Venezuela-Chile,1-3,1968,1611,3-1,3579,357,1.2216014897579144
316,2016,6,3,United States,Colombia,0,2,Copa AmÃ©rica,,1728,2005,United States-Colombia,0-2,2005,1728,2-0,3733,277,1.1603009259259258
321,2016,6,4,Brazil,Ecuador,0,0,Copa AmÃ©rica,US,2012,1883,Brazil-Ecuador,0-0,2012,1883,0-0,3895,129,1.0685077004779606
323,2016,6,4,Costa Rica,Paraguay,0,0,Copa AmÃ©rica,US,1787,1749,Costa Rica-Paraguay,0-0,1787,1749,0-0,3536,38,1.021726700971984
354,2016,6,5,Mexico,Uruguay,3,1,Copa AmÃ©rica,US,1978,1925,Mexico-Uruguay,3-1,1978,1925,3-1,3903,53,1.0275324675324675
365,2016,6,6,Argentina,Chile,2,1,Copa AmÃ©rica,US,2067,1921,Argentina-Chile,2-1,2067,1921,2-1,3988,146,1.0760020822488288
379,2016,6,7,Colombia,Paraguay,2,1,Copa AmÃ©rica,US,2014,1740,Colombia-Paraguay,2-1,2014,1740,2-1,3754,274,1.157471264367816
389,2016,6,7,United States,Costa Rica,4,0,Copa AmÃ©rica,,1769,1746,United States-Costa Rica,4-0,1769,1746,4-0,3515,23,1.0131729667812142
392,2016,6,8,Ecuador,Peru,2,2,Copa AmÃ©rica,US,1876,1792,Ecuador-Peru,2-2,1876,1792,2-2,3668,84,1.046875
398,2016,6,9,Venezuela,Uruguay,1,0,Copa AmÃ©rica,US,1675,1883,Venezuela-Uruguay,1-0,1883,1675,0-1,3558,208,1.124179104477612
399,2016,6,10,Argentina,Panama,4,0,Copa AmÃ©rica,US,2078,1686,Argentina-Panama,4-0,2078,1686,4-0,3764,392,1.232502965599051
401,2016,6,10,France,Romania,2,1,European Championship,,1982,1752,France-Romania,2-1,1982,1752,2-1,3734,230,1.1312785388127853
402,2016,6,11,Costa Rica,Colombia,3,2,Copa AmÃ©rica,US,1787,1973,Costa Rica-Colombia,3-2,1973,1787,2-3,3760,186,1.1040850587576945
403,2016,6,11,England,Russia,1,1,European Championship,FR,1958,1774,England-Russia,1-1,1958,1774,1-1,3732,184,1.1037204058624577
407,2016,6,11,Switzerland,Albania,1,0,European Championship,FR,1786,1601,Switzerland-Albania,1-0,1786,1601,1-0,3387,185,1.1155527795128044
408,2016,6,11,United States,Paraguay,1,0,Copa AmÃ©rica,,1785,1724,United States-Paraguay,1-0,1785,1724,1-0,3509,61,1.03538283062645
409,2016,6,11,Wales,Slovakia,2,1,European Championship,FR,1688,1733,Wales-Slovakia,2-1,1733,1688,1-2,3421,45,1.0266587677725119
411,2016,6,12,Croatia,Turkey,1,0,European Championship,FR,1844,1803,Croatia-Turkey,1-0,1844,1803,1-0,3647,41,1.0227398779811425
413,2016,6,12,Germany,Ukraine,2,0,European Championship,FR,2053,1819,Germany-Ukraine,2-0,2053,1819,2-0,3872,234,1.1286421110500275
416,2016,6,12,Peru,Brazil,1,0,Copa AmÃ©rica,US,1831,1978,Peru-Brazil,1-0,1978,1831,0-1,3809,147,1.0802839978154015
417,2016,6,12,Poland,Northern Ireland,1,0,European Championship,FR,1781,1609,Poland-Northern Ireland,1-0,1781,1609,1-0,3390,172,1.1068986948415165
418,2016,6,13,Ireland,Sweden,1,1,European Championship,FR,1758,1764,Ireland-Sweden,1-1,1764,1758,1-1,3522,6,1.0034129692832765
419,2016,6,13,Italy,Belgium,2,0,European Championship,FR,1918,1879,Italy-Belgium,2-0,1918,1879,2-0,3797,39,1.0207557211282596
421,2016,6,13,Mexico,Venezuela,1,1,Copa AmÃ©rica,US,1967,1693,Mexico-Venezuela,1-1,1967,1693,1-1,3660,274,1.1618428824571767
422,2016,6,13,Spain,Czechia,1,0,European Championship,FR,2003,1745,Spain-Czechia,1-0,2003,1745,1-0,3748,258,1.1478510028653295
426,2016,6,14,Chile,Panama,4,2,Copa AmÃ©rica,US,1942,1671,Chile-Panama,4-2,1942,1671,4-2,3613,271,1.1621783363255536
427,2016,6,14,Hungary,Austria,2,0,European Championship,FR,1743,1732,Hungary-Austria,2-0,1743,1732,2-0,3475,11,1.00635103926097
428,2016,6,14,Iceland,Portugal,1,1,European Championship,FR,1681,1895,Iceland-Portugal,1-1,1895,1681,1-1,3576,214,1.1273051754907792
432,2016,6,15,Romania,Switzerland,1,1,European Championship,FR,1754,1784,Romania-Switzerland,1-1,1784,1754,1-1,3538,30,1.017103762827822
433,2016,6,15,Slovakia,Russia,2,1,European Championship,FR,1761,1746,Slovakia-Russia,2-1,1761,1746,2-1,3507,15,1.0085910652920962
436,2016,6,16,England,Wales,2,1,European Championship,FR,1967,1679,England-Wales,2-1,1967,1679,2-1,3646,288,1.1715306730196546
437,2016,6,16,Germany,Poland,0,0,European Championship,FR,2037,1797,Germany-Poland,0-0,2037,1797,0-0,3834,240,1.1335559265442403
440,2016,6,16,Northern Ireland,Ukraine,2,0,European Championship,FR,1667,1761,Northern Ireland-Ukraine,2-0,1761,1667,0-2,3428,94,1.0563887222555488
441,2016,6,16,United States,Ecuador,2,1,Copa AmÃ©rica,,1810,1860,United States-Ecuador,2-1,1860,1810,1-2,3670,50,1.0276243093922652
442,2016,6,17,Colombia,Peru,0,0,Copa AmÃ©rica,US,1963,1841,Colombia-Peru,0-0,1963,1841,0-0,3804,122,1.0662683324280282
443,2016,6,17,Croatia,Czechia,2,2,European Championship,FR,1837,1752,Croatia-Czechia,2-2,1837,1752,2-2,3589,85,1.04851598173516
444,2016,6,17,Italy,Sweden,1,0,European Championship,FR,1933,1749,Italy-Sweden,1-0,1933,1749,1-0,3682,184,1.1052029731275015
446,2016,6,17,Spain,Turkey,3,0,European Championship,FR,2024,1782,Spain-Turkey,3-0,2024,1782,3-0,3806,242,1.1358024691358024
447,2016,6,18,Argentina,Venezuela,4,1,Copa AmÃ©rica,US,2091,1685,Argentina-Venezuela,4-1,2091,1685,4-1,3776,406,1.2409495548961424
448,2016,6,18,Austria,Portugal,0,0,European Championship,FR,1743,1884,Austria-Portugal,0-0,1884,1743,0-0,3627,141,1.080895008605852
449,2016,6,18,Belgium,Ireland,3,0,European Championship,FR,1908,1729,Belgium-Ireland,3-0,1908,1729,3-0,3637,179,1.103528050896472
450,2016,6,18,Chile,Mexico,4,0,Copa AmÃ©rica,US,2002,1907,Chile-Mexico,4-0,2002,1907,4-0,3909,95,1.049816465652858
451,2016,6,18,Hungary,Iceland,1,1,European Championship,FR,1739,1685,Hungary-Iceland,1-1,1739,1685,1-1,3424,54,1.0320474777448072
454,2016,6,19,Albania,Romania,1,0,European Championship,FR,1633,1718,Albania-Romania,1-0,1718,1633,0-1,3351,85,1.0520514390691977
456,2016,6,19,France,Switzerland,0,0,European Championship,,1968,1802,France-Switzerland,0-0,1968,1802,0-0,3770,166,1.0921198668146503
459,2016,6,20,England,Slovakia,0,0,European Championship,FR,1954,1774,England-Slovakia,0-0,1954,1774,0-0,3728,180,1.1014656144306652
460,2016,6,20,Wales,Russia,3,0,European Championship,FR,1731,1694,Wales-Russia,3-0,1731,1694,3-0,3425,37,1.0218417945690672
461,2016,6,21,Croatia,Spain,2,1,European Championship,FR,1874,1987,Croatia-Spain,2-1,1987,1874,1-2,3861,113,1.060298826040555
462,2016,6,21,Germany,Northern Ireland,1,0,European Championship,FR,2042,1662,Germany-Northern Ireland,1-0,2042,1662,1-0,3704,380,1.2286401925391095
464,2016,6,21,Poland,Ukraine,1,0,European Championship,FR,1819,1739,Poland-Ukraine,1-0,1819,1739,1-0,3558,80,1.0460034502587694
465,2016,6,21,Turkey,Czechia,2,0,European Championship,FR,1816,1718,Turkey-Czechia,2-0,1816,1718,2-0,3534,98,1.0570430733410943
466,2016,6,21,United States,Argentina,0,3,Copa AmÃ©rica,,1786,2115,United States-Argentina,0-3,2115,1786,3-0,3901,329,1.1842105263157894
468,2016,6,22,Belgium,Sweden,1,0,European Championship,FR,1922,1735,Belgium-Sweden,1-0,1922,1735,1-0,3657,187,1.1077809798270892
470,2016,6,22,Chile,Colombia,2,0,Copa AmÃ©rica,US,2035,1930,Chile-Colombia,2-0,2035,1930,2-0,3965,105,1.0544041450777202
471,2016,6,22,Hungary,Portugal,3,3,European Championship,FR,1749,1874,Hungary-Portugal,3-3,1874,1749,3-3,3623,125,1.0714694110920526
472,2016,6,22,Iceland,Austria,2,1,European Championship,FR,1714,1714,Iceland-Austria,2-1,1714,1714,2-1,3428,0,1.0
473,2016,6,22,Ireland,Italy,1,0,European Championship,FR,1767,1895,Ireland-Italy,1-0,1895,1767,0-1,3662,128,1.0724391624221845
477,2016,6,25,Poland,Switzerland,1,1,European Championship,FR,1818,1803,Poland-Switzerland,1-1,1818,1803,1-1,3621,15,1.0083194675540765
478,2016,6,25,Portugal,Croatia,1,0,European Championship,FR,1899,1849,Portugal-Croatia,1-0,1899,1849,1-0,3748,50,1.0270416441319632
481,2016,6,25,United States,Colombia,0,1,Copa AmÃ©rica,,1764,1952,United States-Colombia,0-1,1952,1764,1-0,3716,188,1.1065759637188208
482,2016,6,25,Wales,Northern Ireland,1,0,European Championship,FR,1751,1642,Wales-Northern Ireland,1-0,1751,1642,1-0,3393,109,1.0663824604141292
483,2016,6,26,Argentina,Chile,0,0,Copa AmÃ©rica,US,2109,2041,Argentina-Chile,0-0,2109,2041,0-0,4150,68,1.0333170014698676
484,2016,6,26,Belgium,Hungary,4,0,European Championship,FR,1947,1724,Belgium-Hungary,4-0,1947,1724,4-0,3671,223,1.1293503480278422
486,2016,6,26,France,Ireland,2,1,European Championship,,1976,1759,France-Ireland,2-1,1976,1759,2-1,3735,217,1.1233655486071632
487,2016,6,26,Germany,Slovakia,3,0,European Championship,FR,2057,1759,Germany-Slovakia,3-0,2057,1759,3-0,3816,298,1.1694144400227402
488,2016,6,27,Iceland,England,2,1,European Championship,FR,1754,1914,Iceland-England,2-1,1914,1754,1-2,3668,160,1.0912200684150513
489,2016,6,27,Italy,Spain,2,0,European Championship,FR,1942,1940,Italy-Spain,2-0,1942,1940,2-0,3882,2,1.0010309278350515
491,2016,6,30,Poland,Portugal,1,1,European Championship,FR,1824,1893,Poland-Portugal,1-1,1893,1824,1-1,3717,69,1.037828947368421
493,2016,7,1,Wales,Belgium,3,1,European Championship,FR,1808,1890,Wales-Belgium,3-1,1890,1808,1-3,3698,82,1.045353982300885
494,2016,7,2,Germany,Italy,1,1,European Championship,FR,2049,1950,Germany-Italy,1-1,2049,1950,1-1,3999,99,1.0507692307692307
497,2016,7,3,France,Iceland,4,2,European Championship,,1988,1742,France-Iceland,4-2,1988,1742,4-2,3730,246,1.1412169919632607
500,2016,7,6,Portugal,Wales,2,0,European Championship,FR,1922,1779,Portugal-Wales,2-0,1922,1779,2-0,3701,143,1.0803822372119167
501,2016,7,7,France,Germany,2,0,European Championship,,2021,2016,France-Germany,2-0,2021,2016,2-0,4037,5,1.0024801587301588
502,2016,7,10,France,Portugal,0,1,European Championship,,1983,1960,France-Portugal,0-1,1983,1960,0-1,3943,23,1.011734693877551
533,2016,9,1,Argentina,Uruguay,1,0,World Cup qualifier,,2115,1889,Argentina-Uruguay,1-0,2115,1889,1-0,4004,226,1.119640021175225
537,2016,9,1,Bolivia,Peru,2,0,World Cup qualifier,,1617,1798,Bolivia-Peru,2-0,1798,1617,0-2,3415,181,1.1119356833642549
538,2016,9,1,Colombia,Venezuela,2,0,World Cup qualifier,,1958,1679,Colombia-Venezuela,2-0,1958,1679,2-0,3637,279,1.1661703394877903
539,2016,9,1,Ecuador,Brazil,0,3,World Cup qualifier,,1827,2011,Ecuador-Brazil,0-3,2011,1827,3-0,3838,184,1.100711548987411
546,2016,9,1,Paraguay,Chile,2,1,World Cup qualifier,,1755,2010,Paraguay-Chile,2-1,2010,1755,1-2,3765,255,1.1452991452991452
574,2016,9,4,Czechia,Northern Ireland,0,0,World Cup qualifier,,1713,1652,Czechia-Northern Ireland,0-0,1713,1652,0-0,3365,61,1.0369249394673123
586,2016,9,4,Norway,Germany,0,3,World Cup qualifier,,1611,2028,Norway-Germany,0-3,2028,1611,3-0,3639,417,1.2588454376163873
589,2016,9,4,Slovakia,England,0,1,World Cup qualifier,,1742,1931,Slovakia-England,0-1,1931,1742,1-0,3673,189,1.10849598163031
594,2016,9,5,Croatia,Turkey,1,1,World Cup qualifier,,1841,1818,Croatia-Turkey,1-1,1841,1818,1-1,3659,23,1.0126512651265127
599,2016,9,5,Serbia,Ireland,2,2,World Cup qualifier,,1722,1767,Serbia-Ireland,2-2,1767,1722,2-2,3489,45,1.0261324041811846
601,2016,9,5,Ukraine,Iceland,1,1,World Cup qualifier,,1734,1747,Ukraine-Iceland,1-1,1747,1734,1-1,3481,13,1.0074971164936564
606,2016,9,6,Belarus,France,0,0,World Cup qualifier,,1614,1987,Belarus-France,0-0,1987,1614,0-0,3601,373,1.2311028500619579
608,2016,9,6,Brazil,Colombia,2,1,World Cup qualifier,,2023,1946,Brazil-Colombia,2-1,2023,1946,2-1,3969,77,1.039568345323741
612,2016,9,6,Chile,Bolivia,0,0,World Cup qualifier,,1992,1635,Chile-Bolivia,0-0,1992,1635,0-0,3627,357,1.218348623853211
614,2016,9,6,Costa Rica,Panama,3,1,World Cup qualifier,,1809,1665,Costa Rica-Panama,3-1,1809,1665,3-1,3474,144,1.0864864864864865
626,2016,9,6,Peru,Ecuador,2,1,World Cup qualifier,,1814,1811,Peru-Ecuador,2-1,1814,1811,2-1,3625,3,1.0016565433462175
630,2016,9,6,Sweden,Netherlands,1,1,World Cup qualifier,,1739,1903,Sweden-Netherlands,1-1,1903,1739,1-1,3642,164,1.0943070730304774
631,2016,9,6,Switzerland,Portugal,2,0,World Cup qualifier,,1838,1925,Switzerland-Portugal,2-0,1925,1838,0-2,3763,87,1.0473340587595212
635,2016,9,6,Uruguay,Paraguay,4,0,World Cup qualifier,,1904,1740,Uruguay-Paraguay,4-0,1904,1740,4-0,3644,164,1.0942528735632184
637,2016,9,6,Venezuela,Argentina,2,2,World Cup qualifier,,1694,2100,Venezuela-Argentina,2-2,2100,1694,2-2,3794,406,1.2396694214876034
646,2016,10,6,Austria,Wales,2,2,World Cup qualifier,,1724,1785,Austria-Wales,2-2,1785,1724,2-2,3509,61,1.03538283062645
647,2016,10,6,Brazil,Bolivia,4,0,World Cup qualifier,,2028,1630,Brazil-Bolivia,4-0,2028,1630,4-0,3658,398,1.2441717791411042
652,2016,10,6,Ecuador,Chile,3,0,World Cup qualifier,,1854,1949,Ecuador-Chile,3-0,1949,1854,0-3,3803,95,1.0512405609492987
655,2016,10,6,Italy,Spain,1,1,World Cup qualifier,,1938,1963,Italy-Spain,1-1,1963,1938,1-1,3901,25,1.0128998968008256
661,2016,10,6,Paraguay,Colombia,0,1,World Cup qualifier,,1726,1960,Paraguay-Colombia,0-1,1960,1726,1-0,3686,234,1.1355735805330243
662,2016,10,6,Peru,Argentina,2,2,World Cup qualifier,,1824,2090,Peru-Argentina,2-2,2090,1824,2-2,3914,266,1.1458333333333333
665,2016,10,6,Turkey,Ukraine,2,2,World Cup qualifier,,1808,1744,Turkey-Ukraine,2-2,1808,1744,2-2,3552,64,1.036697247706422
667,2016,10,6,Uruguay,Venezuela,3,0,World Cup qualifier,,1914,1684,Uruguay-Venezuela,3-0,1914,1684,3-0,3598,230,1.1365795724465557
668,2016,10,6,Uzbekistan,Iran,0,1,World Cup qualifier,,1659,1770,Uzbekistan-Iran,0-1,1770,1659,1-0,3429,111,1.0669077757685352
670,2016,10,7,Belgium,Bosnia and Herzegovina,4,0,World Cup qualifier,,1898,1751,Belgium-Bosnia and Herzegovina,4-0,1898,1751,4-0,3649,147,1.0839520274129069
676,2016,10,7,Hungary,Switzerland,2,3,World Cup qualifier,,1690,1856,Hungary-Switzerland,2-3,1856,1690,3-2,3546,166,1.0982248520710058
679,2016,10,7,Netherlands,Belarus,4,1,World Cup qualifier,,1910,1607,Netherlands-Belarus,4-1,1910,1607,4-1,3517,303,1.1885500933416304
694,2016,10,8,Germany,Czechia,3,0,World Cup qualifier,,2034,1707,Germany-Czechia,3-0,2034,1707,3-0,3741,327,1.1915641476274166
699,2016,10,8,Poland,Denmark,3,2,World Cup qualifier,,1820,1739,Poland-Denmark,3-2,1820,1739,3-2,3559,81,1.046578493387004
702,2016,10,8,Slovenia,Slovakia,1,0,World Cup qualifier,,1631,1720,Slovenia-Slovakia,1-0,1720,1631,0-1,3351,89,1.0545677498467199
706,2016,10,9,Albania,Spain,0,2,World Cup qualifier,,1629,1976,Albania-Spain,0-2,1976,1629,2-0,3605,347,1.2130141190914672
707,2016,10,9,Algeria,Cameroon,1,1,World Cup qualifier,,1655,1632,Algeria-Cameroon,1-1,1655,1632,1-1,3287,23,1.014093137254902
711,2016,10,9,Iceland,Turkey,2,0,World Cup qualifier,,1779,1782,Iceland-Turkey,2-0,1782,1779,0-2,3561,3,1.0016863406408094
717,2016,10,9,Serbia,Austria,3,2,World Cup qualifier,,1728,1709,Serbia-Austria,3-2,1728,1709,3-2,3437,19,1.0111176126389703
732,2016,10,10,Netherlands,France,0,1,World Cup qualifier,,1889,2012,Netherlands-France,0-1,2012,1889,1-0,3901,123,1.065113816834304
735,2016,10,11,Argentina,Paraguay,0,1,World Cup qualifier,,2053,1763,Argentina-Paraguay,0-1,2053,1763,0-1,3816,290,1.1644923425978446
736,2016,10,11,Australia,Japan,1,1,World Cup qualifier,,1722,1742,Australia-Japan,1-1,1742,1722,1-1,3464,20,1.0116144018583042
737,2016,10,11,Bolivia,Ecuador,2,2,World Cup qualifier,,1637,1847,Bolivia-Ecuador,2-2,1847,1637,2-2,3484,210,1.1282834453268173
738,2016,10,11,Chile,Peru,2,1,World Cup qualifier,,1958,1815,Chile-Peru,2-1,1958,1815,2-1,3773,143,1.0787878787878789
739,2016,10,11,Colombia,Uruguay,2,2,World Cup qualifier,,1952,1922,Colombia-Uruguay,2-2,1952,1922,2-2,3874,30,1.015608740894901
741,2016,10,11,Denmark,Montenegro,0,1,World Cup qualifier,,1707,1619,Denmark-Montenegro,0-1,1707,1619,0-1,3326,88,1.054354539839407
742,2016,10,11,Germany,Northern Ireland,2,0,World Cup qualifier,,2038,1648,Germany-Northern Ireland,2-0,2038,1648,2-0,3686,390,1.2366504854368932
745,2016,10,11,Iran,South Korea,1,0,World Cup qualifier,,1786,1775,Iran-South Korea,1-0,1786,1775,1-0,3561,11,1.0061971830985916
762,2016,10,11,Slovakia,Scotland,3,0,World Cup qualifier,,1744,1680,Slovakia-Scotland,3-0,1744,1680,3-0,3424,64,1.0380952380952382
763,2016,10,11,Slovenia,England,0,0,World Cup qualifier,,1641,1922,Slovenia-England,0-0,1922,1641,0-0,3563,281,1.1712370505789154
768,2016,10,11,Venezuela,Brazil,0,2,World Cup qualifier,,1672,2040,Venezuela-Brazil,0-2,2040,1672,2-0,3712,368,1.2200956937799043
802,2016,11,10,Brazil,Argentina,3,0,World Cup qualifier,,2066,2027,Brazil-Argentina,3-0,2066,2027,3-0,4093,39,1.0192402565367538
803,2016,11,10,Colombia,Chile,0,0,World Cup qualifier,,1947,1963,Colombia-Chile,0-0,1963,1947,0-0,3910,16,1.0082177709296354
806,2016,11,10,Paraguay,Peru,1,3,World Cup qualifier,,1723,1855,Paraguay-Peru,1-3,1855,1723,3-1,3578,132,1.0766105629715612
808,2016,11,10,Uruguay,Ecuador,2,1,World Cup qualifier,,1933,1836,Uruguay-Ecuador,2-1,1933,1836,2-1,3769,97,1.0528322440087146
810,2016,11,10,Venezuela,Bolivia,4,0,World Cup qualifier,,1697,1612,Venezuela-Bolivia,4-0,1697,1612,4-0,3309,85,1.0527295285359801
815,2016,11,11,England,Scotland,3,0,World Cup qualifier,,1931,1671,England-Scotland,3-0,1931,1671,3-0,3602,260,1.1555954518252542
816,2016,11,11,France,Sweden,2,1,World Cup qualifier,,2017,1751,France-Sweden,2-1,2017,1751,2-1,3768,266,1.1519131924614505
821,2016,11,11,Romania,Poland,0,3,World Cup qualifier,,1688,1858,Romania-Poland,0-3,1858,1688,3-0,3546,170,1.1007109004739337
827,2016,11,11,United States,Mexico,1,2,World Cup qualifier,,1755,1919,United States-Mexico,1-2,1919,1755,2-1,3674,164,1.0934472934472934
829,2016,11,12,Austria,Ireland,0,1,World Cup qualifier,,1687,1801,Austria-Ireland,0-1,1801,1687,1-0,3488,114,1.067575577949022
833,2016,11,12,Croatia,Iceland,2,0,World Cup qualifier,,1874,1763,Croatia-Iceland,2-0,1874,1763,2-0,3637,111,1.0629608621667612
842,2016,11,12,Nigeria,Algeria,3,1,World Cup qualifier,,1669,1633,Nigeria-Algeria,3-1,1669,1633,3-1,3302,36,1.0220453153704838
843,2016,11,12,South Africa,Senegal,2,1,World Cup qualifier,,1620,1673,South Africa-Senegal,2-1,1673,1620,1-2,3293,53,1.032716049382716
849,2016,11,12,Wales,Serbia,1,1,World Cup qualifier,,1760,1736,Wales-Serbia,1-1,1760,1736,1-1,3496,24,1.0138248847926268
854,2016,11,13,Greece,Bosnia and Herzegovina,1,1,World Cup qualifier,,1654,1755,Greece-Bosnia and Herzegovina,1-1,1755,1654,1-1,3409,101,1.0610640870616688
870,2016,11,15,Argentina,Colombia,3,0,World Cup qualifier,,2045,1929,Argentina-Colombia,3-0,2045,1929,3-0,3974,116,1.060134784862623
873,2016,11,15,Bolivia,Paraguay,1,0,World Cup qualifier,,1633,1702,Bolivia-Paraguay,1-0,1702,1633,0-1,3335,69,1.0422535211267605
874,2016,11,15,Chile,Uruguay,3,1,World Cup qualifier,,1982,1914,Chile-Uruguay,3-1,1982,1914,3-1,3896,68,1.0355276907001045
877,2016,11,15,Costa Rica,United States,4,0,World Cup qualifier,,1854,1735,Costa Rica-United States,4-0,1854,1735,4-0,3589,119,1.0685878962536024
879,2016,11,15,Ecuador,Venezuela,3,0,World Cup qualifier,,1850,1683,Ecuador-Venezuela,3-0,1850,1683,3-0,3533,167,1.0992275698158052
894,2016,11,15,Panama,Mexico,0,0,World Cup qualifier,,1689,1911,Panama-Mexico,0-0,1911,1689,0-0,3600,222,1.1314387211367674
895,2016,11,15,Peru,Brazil,0,2,World Cup qualifier,,1834,2087,Peru-Brazil,0-2,2087,1834,2-0,3921,253,1.1379498364231189
897,2016,11,15,South Korea,Uzbekistan,2,1,World Cup qualifier,,1788,1666,South Korea-Uzbekistan,2-1,1788,1666,2-1,3454,122,1.0732292917166866
962,2017,1,17,Panama,Honduras,0,1,CONCACAF Championship qualifier and Central American Cup,,1642,1611,Panama-Honduras,0-1,1642,1611,0-1,3253,31,1.0192427063935443
968,2017,1,20,Costa Rica,Honduras,1,1,CONCACAF Championship qualifier and Central American Cup,PA,1809,1622,Costa Rica-Honduras,1-1,1809,1622,1-1,3431,187,1.1152897657213316
969,2017,1,20,Democratic Republic of Congo,Ivory Coast,2,2,African Nations Cup,GA,1604,1711,Democratic Republic of Congo-Ivory Coast,2-2,1711,1604,2-2,3315,107,1.0667082294264338
980,2017,1,22,Panama,Costa Rica,1,0,CONCACAF Championship qualifier and Central American Cup,,1671,1785,Panama-Costa Rica,1-0,1785,1671,0-1,3456,114,1.0682226211849193
981,2017,1,23,Algeria,Senegal,2,2,African Nations Cup,GA,1604,1719,Algeria-Senegal,2-2,1719,1604,2-2,3323,115,1.0716957605985038
985,2017,1,24,Morocco,Ivory Coast,1,0,African Nations Cup,GA,1621,1677,Morocco-Ivory Coast,1-0,1677,1621,0-1,3298,56,1.0345465761875385
987,2017,1,25,Egypt,Ghana,1,0,African Nations Cup,GA,1700,1609,Egypt-Ghana,1-0,1700,1609,1-0,3309,91,1.0565568676196395
991,2017,1,28,Cameroon,Senegal,0,0,African Nations Cup,GA,1621,1712,Cameroon-Senegal,0-0,1712,1621,0-0,3333,91,1.05613818630475
992,2017,1,29,Egypt,Morocco,1,0,African Nations Cup,GA,1719,1602,Egypt-Morocco,1-0,1719,1602,1-0,3321,117,1.0730337078651686
999,2017,2,5,Cameroon,Egypt,2,1,African Nations Cup,GA,1689,1681,Cameroon-Egypt,2-1,1689,1681,2-1,3370,8,1.0047590719809638
1024,2017,3,23,Argentina,Chile,1,0,World Cup qualifier,,2056,1974,Argentina-Chile,1-0,2056,1974,1-0,4030,82,1.0415400202634246
1027,2017,3,23,Colombia,Bolivia,1,0,World Cup qualifier,,1929,1629,Colombia-Bolivia,1-0,1929,1629,1-0,3558,300,1.1841620626151013
1033,2017,3,23,Paraguay,Ecuador,2,1,World Cup qualifier,,1725,1831,Paraguay-Ecuador,2-1,1831,1725,1-2,3556,106,1.0614492753623188
1038,2017,3,23,Uruguay,Brazil,1,3,World Cup qualifier,,1887,2118,Uruguay-Brazil,1-3,2118,1887,3-1,4005,231,1.12241653418124
1039,2017,3,23,Venezuela,Peru,2,2,World Cup qualifier,,1686,1831,Venezuela-Peru,2-2,1831,1686,2-2,3517,145,1.0860023724792407
1042,2017,3,24,Croatia,Ukraine,1,0,World Cup qualifier,,1889,1760,Croatia-Ukraine,1-0,1889,1760,1-0,3649,129,1.0732954545454545
1046,2017,3,24,Ireland,Wales,0,0,World Cup qualifier,,1793,1768,Ireland-Wales,0-0,1793,1768,0-0,3561,25,1.0141402714932126
1052,2017,3,24,Mexico,Costa Rica,2,0,World Cup qualifier,,1929,1773,Mexico-Costa Rica,2-0,1929,1773,2-0,3702,156,1.0879864636209813
1055,2017,3,24,Spain,Israel,4,1,World Cup qualifier,,1985,1622,Spain-Israel,4-1,1985,1622,4-1,3607,363,1.2237977805178792
1061,2017,3,25,Belgium,Greece,1,1,World Cup qualifier,,1890,1669,Belgium-Greece,1-1,1890,1669,1-1,3559,221,1.1324146195326543
1063,2017,3,25,Bulgaria,Netherlands,2,0,World Cup qualifier,,1632,1843,Bulgaria-Netherlands,2-0,1843,1632,0-2,3475,211,1.1292892156862746
1068,2017,3,25,Portugal,Hungary,3,0,World Cup qualifier,,1940,1682,Portugal-Hungary,3-0,1940,1682,3-0,3622,258,1.1533888228299642
1082,2017,3,26,Romania,Denmark,0,0,World Cup qualifier,,1677,1720,Romania-Denmark,0-0,1720,1677,0-0,3397,43,1.0256410256410255
1084,2017,3,26,Scotland,Slovenia,1,0,World Cup qualifier,,1679,1639,Scotland-Slovenia,1-0,1679,1639,1-0,3318,40,1.024405125076266
1096,2017,3,28,Bolivia,Argentina,2,0,World Cup qualifier,,1681,2004,Bolivia-Argentina,2-0,2004,1681,0-2,3685,323,1.1921475312314098
1097,2017,3,28,Brazil,Paraguay,3,0,World Cup qualifier,,2122,1721,Brazil-Paraguay,3-0,2122,1721,3-0,3843,401,1.2330040674026728
1098,2017,3,28,Chile,Venezuela,3,1,World Cup qualifier,,1980,1680,Chile-Venezuela,3-1,1980,1680,3-1,3660,300,1.1785714285714286
1099,2017,3,28,Ecuador,Colombia,0,2,World Cup qualifier,,1801,1959,Ecuador-Colombia,0-2,1959,1801,2-0,3760,158,1.087729039422543
1124,2017,3,28,Panama,United States,1,1,World Cup qualifier,,1644,1752,Panama-United States,1-1,1752,1644,1-1,3396,108,1.0656934306569343
1125,2017,3,28,Peru,Uruguay,2,1,World Cup qualifier,,1848,1870,Peru-Uruguay,2-1,1870,1848,1-2,3718,22,1.0119047619047619
1200,2017,6,8,Australia,Saudi Arabia,3,2,World Cup qualifier,,1720,1605,Australia-Saudi Arabia,3-2,1720,1605,3-2,3325,115,1.071651090342679
1202,2017,6,8,Costa Rica,Panama,0,0,World Cup qualifier,,1757,1655,Costa Rica-Panama,0-0,1757,1655,0-0,3412,102,1.061631419939577
1211,2017,6,9,Bosnia and Herzegovina,Greece,0,0,World Cup qualifier,,1754,1679,Bosnia and Herzegovina-Greece,0-0,1754,1679,0-0,3433,75,1.0446694460988684
1221,2017,6,9,Sweden,France,2,1,World Cup qualifier,,1813,1968,Sweden-France,2-1,1968,1813,1-2,3781,155,1.0854936569222284
1226,2017,6,10,Cameroon,Morocco,1,0,African Nations Cup qualifier,,1694,1602,Cameroon-Morocco,1-0,1694,1602,1-0,3296,92,1.0574282147315854
1238,2017,6,10,Nigeria,South Africa,0,2,African Nations Cup qualifier,,1633,1651,Nigeria-South Africa,0-2,1651,1633,2-0,3284,18,1.011022657685242
1240,2017,6,10,Poland,Romania,3,1,World Cup qualifier,,1873,1667,Poland-Romania,3-1,1873,1667,3-1,3540,206,1.1235752849430114
1241,2017,6,10,Scotland,England,2,2,World Cup qualifier,,1687,1918,Scotland-England,2-2,1918,1687,2-2,3605,231,1.1369294605809128
1254,2017,6,11,Iceland,Croatia,1,0,World Cup qualifier,,1802,1851,Iceland-Croatia,1-0,1851,1802,0-1,3653,49,1.0271920088790234
1255,2017,6,11,Ireland,Austria,1,1,World Cup qualifier,,1776,1695,Ireland-Austria,1-1,1776,1695,1-1,3471,81,1.047787610619469
1260,2017,6,11,Mexico,United States,1,1,World Cup qualifier,,1922,1766,Mexico-United States,1-1,1922,1766,1-1,3688,156,1.0883352208380521
1263,2017,6,11,Serbia,Wales,1,1,World Cup qualifier,,1742,1772,Serbia-Wales,1-1,1772,1742,1-1,3514,30,1.0172215843857635
1267,2017,6,12,Iran,Uzbekistan,2,0,World Cup qualifier,,1794,1636,Iran-Uzbekistan,2-0,1794,1636,2-0,3430,158,1.0965770171149145
1301,2017,6,18,Chile,Cameroon,2,0,Confederations Cup,RU,1975,1674,Chile-Cameroon,2-0,1975,1674,2-0,3649,301,1.1798088410991636
1302,2017,6,18,Mexico,Portugal,2,2,Confederations Cup,RU,1923,1929,Mexico-Portugal,2-2,1929,1923,2-2,3852,6,1.0031201248049921
1303,2017,6,19,Germany,Australia,3,2,Confederations Cup,RU,2048,1707,Germany-Australia,3-2,2048,1707,3-2,3755,341,1.1997656707674282
1305,2017,6,21,Russia,Portugal,0,1,Confederations Cup,,1700,1946,Russia-Portugal,0-1,1946,1700,1-0,3646,246,1.1447058823529412
1306,2017,6,22,Australia,Cameroon,1,1,Confederations Cup,RU,1705,1676,Australia-Cameroon,1-1,1705,1676,1-1,3381,29,1.0173031026252983
1307,2017,6,22,Chile,Germany,1,1,Confederations Cup,RU,1980,2043,Chile-Germany,1-1,2043,1980,1-1,4023,63,1.0318181818181817
1311,2017,6,24,Russia,Mexico,1,2,Confederations Cup,,1684,1944,Russia-Mexico,1-2,1944,1684,2-1,3628,260,1.154394299287411
1313,2017,6,25,Australia,Chile,1,1,Confederations Cup,RU,1721,1964,Australia-Chile,1-1,1964,1721,1-1,3685,243,1.1411969785008715
1315,2017,6,25,Germany,Cameroon,3,1,Confederations Cup,RU,2051,1668,Germany-Cameroon,3-1,2051,1668,3-1,3719,383,1.2296163069544364
1322,2017,6,28,Chile,Portugal,0,0,Confederations Cup,RU,1963,1955,Chile-Portugal,0-0,1963,1955,0-0,3918,8,1.0040920716112531
1329,2017,6,29,Germany,Mexico,4,1,Confederations Cup,RU,2082,1915,Germany-Mexico,4-1,2082,1915,4-1,3997,167,1.0872062663185378
1339,2017,7,2,Germany,Chile,1,0,Confederations Cup,RU,2099,1946,Germany-Chile,1-0,2099,1946,1-0,4045,153,1.078622816032888
1340,2017,7,2,Portugal,Mexico,2,1,Confederations Cup,RU,1977,1898,Portugal-Mexico,2-1,1977,1898,2-1,3875,79,1.041622760800843
1359,2017,7,8,United States,Panama,1,1,CONCACAF Championship,,1755,1660,United States-Panama,1-1,1755,1660,1-1,3415,95,1.0572289156626506
1376,2017,7,19,Costa Rica,Panama,1,0,CONCACAF Championship,US,1787,1666,Costa Rica-Panama,1-0,1787,1666,1-0,3453,121,1.0726290516206483
1380,2017,7,22,United States,Costa Rica,2,0,CONCACAF Championship,,1797,1758,United States-Costa Rica,2-0,1797,1758,2-0,3555,39,1.022184300341297
1399,2017,8,31,Brazil,Ecuador,2,0,World Cup qualifier,,2120,1799,Brazil-Ecuador,2-0,2120,1799,2-0,3919,321,1.1784324624791551
1400,2017,8,31,Bulgaria,Sweden,3,2,World Cup qualifier,,1638,1784,Bulgaria-Sweden,3-2,1784,1638,2-3,3422,146,1.089133089133089
1401,2017,8,31,Chile,Paraguay,0,3,World Cup qualifier,,1885,1769,Chile-Paraguay,0-3,1885,1769,0-3,3654,116,1.0655737704918034
1404,2017,8,31,France,Netherlands,4,0,World Cup qualifier,,1990,1833,France-Netherlands,4-0,1990,1833,4-0,3823,157,1.0856519367157664
1408,2017,8,31,Japan,Australia,2,0,World Cup qualifier,,1780,1702,Japan-Australia,2-0,1780,1702,2-0,3482,78,1.045828437132785
1410,2017,8,31,Peru,Bolivia,2,1,World Cup qualifier,,1861,1679,Peru-Bolivia,2-1,1861,1679,2-1,3540,182,1.1083978558665872
1413,2017,8,31,South Korea,Iran,0,0,World Cup qualifier,,1730,1796,South Korea-Iran,0-0,1796,1730,0-0,3526,66,1.038150289017341
1419,2017,8,31,Uruguay,Argentina,0,0,World Cup qualifier,,1846,2013,Uruguay-Argentina,0-0,2013,1846,0-0,3859,167,1.090465872156013
1420,2017,8,31,Venezuela,Colombia,0,0,World Cup qualifier,,1698,1960,Venezuela-Colombia,0-0,1960,1698,0-0,3658,262,1.154299175500589
1422,2017,9,1,Czechia,Germany,1,2,World Cup qualifier,,1692,2105,Czechia-Germany,1-2,2105,1692,2-1,3797,413,1.2440898345153664
1423,2017,9,1,Denmark,Poland,4,0,World Cup qualifier,,1779,1832,Denmark-Poland,4-0,1832,1779,0-4,3611,53,1.0297920179876334
1428,2017,9,1,Mexico,Panama,1,0,World Cup qualifier,,1854,1659,Mexico-Panama,1-0,1854,1659,1-0,3513,195,1.1175406871609403
1431,2017,9,1,Nigeria,Cameroon,4,0,World Cup qualifier,,1664,1637,Nigeria-Cameroon,4-0,1664,1637,4-0,3301,27,1.0164935858277337
1435,2017,9,1,Slovakia,Slovenia,1,0,World Cup qualifier,,1776,1633,Slovakia-Slovenia,1-0,1776,1633,1-0,3409,143,1.0875688916105328
1438,2017,9,1,United States,Costa Rica,0,2,World Cup qualifier,,1762,1800,United States-Costa Rica,0-2,1800,1762,2-0,3562,38,1.0215664018161181
1447,2017,9,2,Senegal,Burkina Faso,0,0,World Cup qualifier,,1698,1621,Senegal-Burkina Faso,0-0,1698,1621,0-0,3319,77,1.0475015422578655
1449,2017,9,2,Spain,Italy,3,0,World Cup qualifier,,2026,1948,Spain-Italy,3-0,2026,1948,3-0,3974,78,1.040041067761807
1451,2017,9,2,Ukraine,Turkey,2,0,World Cup qualifier,,1780,1769,Ukraine-Turkey,2-0,1780,1769,2-0,3549,11,1.0062182023742228
1452,2017,9,2,Wales,Austria,1,0,World Cup qualifier,,1783,1684,Wales-Austria,1-0,1783,1684,1-0,3467,99,1.0587885985748218
1461,2017,9,3,Greece,Belgium,1,2,World Cup qualifier,,1652,1912,Greece-Belgium,1-2,1912,1652,2-1,3564,260,1.1573849878934626
1462,2017,9,3,Hungary,Portugal,0,1,World Cup qualifier,,1620,1986,Hungary-Portugal,0-1,1986,1620,1-0,3606,366,1.2259259259259259
1464,2017,9,3,Netherlands,Bulgaria,3,1,World Cup qualifier,,1842,1629,Netherlands-Bulgaria,3-1,1842,1629,3-1,3471,213,1.130755064456722
1467,2017,9,4,Cameroon,Nigeria,1,1,World Cup qualifier,,1633,1668,Cameroon-Nigeria,1-1,1668,1633,1-1,3301,35,1.0214329454990814
1468,2017,9,4,England,Slovakia,2,1,World Cup qualifier,,1922,1768,England-Slovakia,2-1,1922,1768,2-1,3690,154,1.08710407239819
1472,2017,9,4,Montenegro,Romania,1,0,World Cup qualifier,,1639,1671,Montenegro-Romania,1-0,1671,1639,0-1,3310,32,1.019524100061013
1473,2017,9,4,Northern Ireland,Czechia,2,0,World Cup qualifier,,1704,1670,Northern Ireland-Czechia,2-0,1704,1670,2-0,3374,34,1.0203592814371258
1478,2017,9,5,Argentina,Venezuela,1,1,World Cup qualifier,,1996,1715,Argentina-Venezuela,1-1,1996,1715,1-1,3711,281,1.1638483965014577
1483,2017,9,5,Bolivia,Chile,1,0,World Cup qualifier,,1705,1859,Bolivia-Chile,1-0,1859,1705,0-1,3564,154,1.0903225806451613
1484,2017,9,5,Burkina Faso,Senegal,2,2,World Cup qualifier,,1620,1699,Burkina Faso-Senegal,2-2,1699,1620,2-2,3319,79,1.0487654320987654
1486,2017,9,5,Colombia,Brazil,1,1,World Cup qualifier,,1963,2117,Colombia-Brazil,1-1,2117,1963,1-1,4080,154,1.0784513499745287
1488,2017,9,5,Costa Rica,Mexico,1,1,World Cup qualifier,,1797,1857,Costa Rica-Mexico,1-1,1857,1797,1-1,3654,60,1.0333889816360602
1490,2017,9,5,Ecuador,Peru,1,2,World Cup qualifier,,1777,1883,Ecuador-Peru,1-2,1883,1777,2-1,3660,106,1.0596510973550928
1494,2017,9,5,Iceland,Ukraine,2,0,World Cup qualifier,,1795,1758,Iceland-Ukraine,2-0,1795,1758,2-0,3553,37,1.0210466439135382
1495,2017,9,5,Iran,Syria,2,2,World Cup qualifier,,1782,1613,Iran-Syria,2-2,1782,1613,2-2,3395,169,1.1047737135771853
1497,2017,9,5,Ireland,Serbia,0,1,World Cup qualifier,,1738,1773,Ireland-Serbia,0-1,1773,1738,1-0,3511,35,1.020138089758343
1512,2017,9,5,Paraguay,Uruguay,1,2,World Cup qualifier,,1748,1867,Paraguay-Uruguay,1-2,1867,1748,2-1,3615,119,1.0680778032036613
1515,2017,9,5,Saudi Arabia,Japan,1,0,World Cup qualifier,,1612,1755,Saudi Arabia-Japan,1-0,1755,1612,0-1,3367,143,1.0887096774193548
1519,2017,9,5,Turkey,Croatia,1,0,World Cup qualifier,,1788,1833,Turkey-Croatia,1-0,1833,1788,0-1,3621,45,1.0251677852348993
1520,2017,9,5,Uzbekistan,South Korea,0,0,World Cup qualifier,,1620,1729,Uzbekistan-South Korea,0-0,1729,1620,0-0,3349,109,1.067283950617284
1526,2017,10,5,Argentina,Peru,0,0,World Cup qualifier,,1985,1894,Argentina-Peru,0-0,1985,1894,0-0,3879,91,1.0480464625131996
1529,2017,10,5,Bolivia,Brazil,0,0,World Cup qualifier,,1719,2103,Bolivia-Brazil,0-0,2103,1719,0-0,3822,384,1.2233856893542758
1530,2017,10,5,Chile,Ecuador,2,1,World Cup qualifier,,1869,1767,Chile-Ecuador,2-1,1869,1767,2-1,3636,102,1.0577249575551784
1531,2017,10,5,Colombia,Paraguay,1,2,World Cup qualifier,,1929,1782,Colombia-Paraguay,1-2,1929,1782,1-2,3711,147,1.0824915824915824
1532,2017,10,5,England,Slovenia,1,0,World Cup qualifier,,1926,1640,England-Slovenia,1-0,1926,1640,1-0,3566,286,1.174390243902439
1537,2017,10,5,Montenegro,Denmark,0,1,World Cup qualifier,,1622,1814,Montenegro-Denmark,0-1,1814,1622,1-0,3436,192,1.1183723797780518
1539,2017,10,5,Northern Ireland,Germany,1,3,World Cup qualifier,,1695,2116,Northern Ireland-Germany,1-3,2116,1695,3-1,3811,421,1.2483775811209439
1543,2017,10,5,Scotland,Slovakia,1,0,World Cup qualifier,,1729,1750,Scotland-Slovakia,1-0,1750,1729,0-1,3479,21,1.0121457489878543
1544,2017,10,5,Syria,Australia,1,1,World Cup qualifier,MY,1618,1701,Syria-Australia,1-1,1701,1618,1-1,3319,83,1.0512978986402968
1546,2017,10,5,Venezuela,Uruguay,0,0,World Cup qualifier,,1718,1864,Venezuela-Uruguay,0-0,1864,1718,0-0,3582,146,1.0849825378346916
1547,2017,10,6,Austria,Serbia,3,2,World Cup qualifier,,1690,1753,Austria-Serbia,3-2,1753,1690,2-3,3443,63,1.0372781065088756
1558,2017,10,6,Spain,Albania,3,0,World Cup qualifier,,2030,1601,Spain-Albania,3-0,2030,1601,3-0,3631,429,1.2679575265459089
1559,2017,10,6,Turkey,Iceland,0,3,World Cup qualifier,,1744,1839,Turkey-Iceland,0-3,1839,1744,3-0,3583,95,1.0544724770642202
1560,2017,10,6,United States,Panama,4,0,World Cup qualifier,,1776,1648,United States-Panama,4-0,1776,1648,4-0,3424,128,1.0776699029126213
1563,2017,10,7,Bosnia and Herzegovina,Belgium,3,3,World Cup qualifier,,1709,1927,Bosnia and Herzegovina-Belgium,3-3,1927,1709,3-3,3636,218,1.1275599765944997
1564,2017,10,7,Bulgaria,France,0,1,World Cup qualifier,,1621,1978,Bulgaria-France,0-1,1978,1621,1-0,3599,357,1.2202344231955582
1580,2017,10,7,Switzerland,Hungary,4,2,World Cup qualifier,,1880,1612,Switzerland-Hungary,4-2,1880,1612,4-2,3492,268,1.1662531017369726
1584,2017,10,8,Denmark,Romania,1,1,World Cup qualifier,,1802,1688,Denmark-Romania,1-1,1802,1688,1-1,3490,114,1.0675355450236967
1590,2017,10,8,Norway,Northern Ireland,1,0,World Cup qualifier,,1600,1674,Norway-Northern Ireland,1-0,1674,1600,0-1,3274,74,1.04625
1591,2017,10,8,Poland,Montenegro,4,2,World Cup qualifier,,1857,1614,Poland-Montenegro,4-2,1857,1614,4-2,3471,243,1.1505576208178439
1593,2017,10,8,Slovenia,Scotland,2,2,World Cup qualifier,,1639,1730,Slovenia-Scotland,2-2,1730,1639,2-2,3369,91,1.055521659548505
1603,2017,10,9,Ukraine,Croatia,0,2,World Cup qualifier,,1730,1851,Ukraine-Croatia,0-2,1851,1730,2-0,3581,121,1.069942196531792
1604,2017,10,9,Wales,Ireland,0,1,World Cup qualifier,,1772,1770,Wales-Ireland,0-1,1772,1770,0-1,3542,2,1.001129943502825
1606,2017,10,10,Australia,Syria,2,1,World Cup qualifier,,1711,1608,Australia-Syria,2-1,1711,1608,2-1,3319,103,1.0640547263681592
1609,2017,10,10,Brazil,Chile,3,0,World Cup qualifier,,2112,1860,Brazil-Chile,3-0,2112,1860,3-0,3972,252,1.135483870967742
1610,2017,10,10,Ecuador,Argentina,1,3,World Cup qualifier,,1747,2005,Ecuador-Argentina,1-3,2005,1747,3-1,3752,258,1.1476817401259303
1614,2017,10,10,Honduras,Mexico,3,2,World Cup qualifier,,1626,1830,Honduras-Mexico,3-2,1830,1626,2-3,3456,204,1.1254612546125462
1625,2017,10,10,Netherlands,Sweden,2,0,World Cup qualifier,,1873,1792,Netherlands-Sweden,2-0,1873,1792,2-0,3665,81,1.0452008928571428
1627,2017,10,10,Panama,Costa Rica,2,1,World Cup qualifier,,1670,1761,Panama-Costa Rica,2-1,1761,1670,1-2,3431,91,1.0544910179640719
1628,2017,10,10,Paraguay,Venezuela,0,1,World Cup qualifier,,1753,1747,Paraguay-Venezuela,0-1,1753,1747,0-1,3500,6,1.003434459072696
1629,2017,10,10,Peru,Colombia,1,1,World Cup qualifier,,1890,1933,Peru-Colombia,1-1,1933,1890,1-1,3823,43,1.0227513227513227
1631,2017,10,10,Portugal,Switzerland,2,0,World Cup qualifier,,2000,1866,Portugal-Switzerland,2-0,2000,1866,2-0,3866,134,1.0718113612004287
1639,2017,10,10,Uruguay,Bolivia,4,2,World Cup qualifier,,1876,1707,Uruguay-Bolivia,4-2,1876,1707,4-2,3583,169,1.09900410076157
1651,2017,11,9,Croatia,Greece,4,1,World Cup qualifier,,1862,1656,Croatia-Greece,4-1,1862,1656,4-1,3518,206,1.1243961352657006
1656,2017,11,9,Northern Ireland,Switzerland,0,1,World Cup qualifier,,1659,1881,Northern Ireland-Switzerland,0-1,1881,1659,1-0,3540,222,1.1338155515370705
1667,2017,11,10,Honduras,Australia,0,0,World Cup qualifier,,1625,1712,Honduras-Australia,0-0,1712,1625,0-0,3337,87,1.0535384615384615
1673,2017,11,10,Sweden,Italy,1,0,World Cup qualifier,,1815,1916,Sweden-Italy,1-0,1916,1815,0-1,3731,101,1.0556473829201103
1677,2017,11,11,Denmark,Ireland,0,0,World Cup qualifier,,1795,1777,Denmark-Ireland,0-0,1795,1777,0-0,3572,18,1.0101294316263365
1681,2017,11,11,Ivory Coast,Morocco,0,2,World Cup qualifier,,1603,1691,Ivory Coast-Morocco,0-2,1691,1603,2-0,3294,88,1.0548970679975047
1694,2017,11,12,Ghana,Egypt,1,1,World Cup qualifier,,1617,1658,Ghana-Egypt,1-1,1658,1617,1-1,3275,41,1.0253555967841683
1695,2017,11,12,Greece,Croatia,0,0,World Cup qualifier,,1662,1856,Greece-Croatia,0-0,1856,1662,0-0,3518,194,1.1167268351383874
1697,2017,11,12,Switzerland,Northern Ireland,0,0,World Cup qualifier,,1866,1674,Switzerland-Northern Ireland,0-0,1866,1674,0-0,3540,192,1.114695340501792
1704,2017,11,13,Italy,Sweden,0,0,World Cup qualifier,,1906,1825,Italy-Sweden,0-0,1906,1825,0-0,3731,81,1.0443835616438357
1722,2017,11,14,Ireland,Denmark,1,3,World Cup qualifier,,1731,1841,Ireland-Denmark,1-3,1841,1731,3-1,3572,110,1.0635470826112075
1741,2017,11,15,Australia,Honduras,3,1,World Cup qualifier,,1727,1610,Australia-Honduras,3-1,1727,1610,3-1,3337,117,1.0726708074534161
1794,2017,12,16,Japan,South Korea,1,3,East Asian Championship,,1706,1760,Japan-South Korea,1-3,1760,1706,3-1,3466,54,1.0316529894490034
2209,2018,9,6,Czechia,Ukraine,1,2,European Nations League B,,1689,1775,Czechia-Ukraine,1-2,1775,1689,2-1,3464,86,1.0509177027827117
2211,2018,9,6,Germany,France,0,0,European Nations League A,,1968,2123,Germany-France,0-0,2123,1968,0-0,4091,155,1.078760162601626
2224,2018,9,6,Slovenia,Bulgaria,1,2,European Nations League C,,1600,1640,Slovenia-Bulgaria,1-2,1640,1600,2-1,3240,40,1.025
2227,2018,9,6,Wales,Ireland,4,1,European Nations League B,,1798,1707,Wales-Ireland,4-1,1798,1707,4-1,3505,91,1.053309900410076
2237,2018,9,7,Italy,Poland,1,1,European Nations League A,,1880,1794,Italy-Poland,1-1,1880,1794,1-1,3674,86,1.0479375696767002
2241,2018,9,7,Romania,Montenegro,0,0,European Nations League C,,1715,1609,Romania-Montenegro,0-0,1715,1609,0-0,3324,106,1.0658794282162833
2246,2018,9,7,Turkey,Russia,1,2,European Nations League B,,1702,1747,Turkey-Russia,1-2,1747,1702,2-1,3449,45,1.026439482961222
2255,2018,9,8,England,Spain,1,2,European Nations League A,,1893,2030,England-Spain,1-2,2030,1893,2-1,3923,137,1.0723718964606446
2268,2018,9,8,Northern Ireland,Bosnia and Herzegovina,1,2,European Nations League B,,1654,1766,Northern Ireland-Bosnia and Herzegovina,1-2,1766,1654,2-1,3420,112,1.067714631197098
2273,2018,9,8,Switzerland,Iceland,4,0,European Nations League A,,1894,1693,Switzerland-Iceland,4-0,1894,1693,4-0,3587,201,1.1187241582988778
2277,2018,9,9,Bulgaria,Norway,1,0,European Nations League C,,1655,1632,Bulgaria-Norway,1-0,1655,1632,1-0,3287,23,1.014093137254902
2281,2018,9,9,Denmark,Wales,2,0,European Nations League B,,1891,1782,Denmark-Wales,2-0,1891,1782,2-0,3673,109,1.0611672278338946
2285,2018,9,9,France,Netherlands,2,1,European Nations League A,,2129,1908,France-Netherlands,2-1,2129,1908,2-1,4037,221,1.1158280922431867
2301,2018,9,9,Ukraine,Slovakia,1,0,European Nations League B,,1789,1758,Ukraine-Slovakia,1-0,1789,1758,1-0,3547,31,1.0176336746302617
2312,2018,9,10,Portugal,Italy,1,0,European Nations League A,,1948,1868,Portugal-Italy,1-0,1948,1868,1-0,3816,80,1.0428265524625269
2316,2018,9,10,Serbia,Romania,2,2,European Nations League C,,1771,1724,Serbia-Romania,2-2,1771,1724,2-2,3495,47,1.027262180974478
2317,2018,9,10,Sweden,Turkey,2,3,European Nations League B,,1818,1734,Sweden-Turkey,2-3,1818,1734,2-3,3552,84,1.0484429065743945
2319,2018,9,11,Bosnia and Herzegovina,Austria,1,0,European Nations League B,,1780,1744,Bosnia and Herzegovina-Austria,1-0,1780,1744,1-0,3524,36,1.0206422018348624
2327,2018,9,11,Iceland,Belgium,0,3,European Nations League A,,1681,2077,Iceland-Belgium,0-3,2077,1681,3-0,3758,396,1.2355740630577037
2341,2018,9,11,Spain,Croatia,4,0,European Nations League A,,2052,1924,Spain-Croatia,4-0,2052,1924,4-0,3976,128,1.0665280665280665
2378,2018,10,11,Poland,Portugal,2,3,European Nations League A,,1772,1965,Poland-Portugal,2-3,1965,1772,3-2,3737,193,1.1089164785553047
2379,2018,10,11,Russia,Sweden,0,0,European Nations League B,,1756,1820,Russia-Sweden,0-0,1820,1756,0-0,3576,64,1.0364464692482915
2385,2018,10,12,Austria,Northern Ireland,1,0,European Nations League B,,1754,1651,Austria-Northern Ireland,1-0,1754,1651,1-0,3405,103,1.0623864324651726
2388,2018,10,12,Belgium,Switzerland,2,1,European Nations League A,,2083,1881,Belgium-Switzerland,2-1,2083,1881,2-1,3964,202,1.1073896863370547
2393,2018,10,12,Croatia,England,0,0,European Nations League A,,1917,1907,Croatia-England,0-0,1917,1907,0-0,3824,10,1.0052438384897746
2422,2018,10,13,Ireland,Denmark,0,0,European Nations League B,,1716,1887,Ireland-Denmark,0-0,1887,1716,0-0,3603,171,1.0996503496503496
2428,2018,10,13,Netherlands,Germany,3,0,European Nations League A,,1939,1942,Netherlands-Germany,3-0,1942,1939,0-3,3881,3,1.001547189272821
2434,2018,10,13,Slovakia,Czechia,1,2,European Nations League B,,1728,1708,Slovakia-Czechia,1-2,1728,1708,1-2,3436,20,1.0117096018735363
2450,2018,10,14,Poland,Italy,0,1,European Nations League A,,1751,1884,Poland-Italy,0-1,1884,1751,1-0,3635,133,1.0759565962307254
2451,2018,10,14,Romania,Serbia,0,0,European Nations League C,,1730,1798,Romania-Serbia,0-0,1798,1730,0-0,3528,68,1.039306358381503
2452,2018,10,14,Russia,Turkey,2,0,European Nations League B,,1776,1712,Russia-Turkey,2-0,1776,1712,2-0,3488,64,1.0373831775700935
2457,2018,10,15,Bosnia and Herzegovina,Northern Ireland,2,0,European Nations League B,,1795,1638,Bosnia and Herzegovina-Northern Ireland,2-0,1795,1638,2-0,3433,157,1.095848595848596
2460,2018,10,15,Finland,Greece,2,0,European Nations League C,,1665,1631,Finland-Greece,2-0,1665,1631,2-0,3296,34,1.0208461066830166
2461,2018,10,15,Iceland,Switzerland,1,2,European Nations League A,,1675,1896,Iceland-Switzerland,1-2,1896,1675,2-1,3571,221,1.1319402985074627
2465,2018,10,15,Spain,England,2,3,European Nations League A,,2029,1940,Spain-England,2-3,2029,1940,2-3,3969,89,1.0458762886597939
2482,2018,10,16,France,Germany,2,1,European Nations League A,,2127,1935,France-Germany,2-1,2127,1935,2-1,4062,192,1.0992248062015504
2489,2018,10,16,Ireland,Wales,0,1,European Nations League B,,1693,1795,Ireland-Wales,0-1,1795,1693,1-0,3488,102,1.0602480803307737
2505,2018,10,16,Norway,Bulgaria,1,0,European Nations League C,,1658,1645,Norway-Bulgaria,1-0,1658,1645,1-0,3303,13,1.00790273556231
2514,2018,10,16,Ukraine,Czechia,1,0,European Nations League B,,1804,1698,Ukraine-Czechia,1-0,1804,1698,1-0,3502,106,1.0624263839811543
2535,2018,11,15,Austria,Bosnia and Herzegovina,0,0,European Nations League B,,1745,1798,Austria-Bosnia and Herzegovina,0-0,1798,1745,0-0,3543,53,1.0303724928366762
2536,2018,11,15,Belgium,Iceland,2,0,European Nations League A,,2080,1672,Belgium-Iceland,2-0,2080,1672,2-0,3752,408,1.244019138755981
2537,2018,11,15,Croatia,Spain,3,2,European Nations League A,,1939,2008,Croatia-Spain,3-2,2008,1939,2-3,3947,69,1.035585353274884
2540,2018,11,15,Greece,Finland,1,0,European Nations League C,,1647,1649,Greece-Finland,1-0,1649,1647,0-1,3296,2,1.0012143290831816
2558,2018,11,16,Egypt,Tunisia,3,2,African Nations Cup qualifier,,1617,1661,Egypt-Tunisia,3-2,1661,1617,2-3,3278,44,1.0272108843537415
2566,2018,11,16,Morocco,Cameroon,2,0,African Nations Cup qualifier,,1719,1600,Morocco-Cameroon,2-0,1719,1600,2-0,3319,119,1.074375
2567,2018,11,16,Netherlands,France,2,0,European Nations League A,,1982,2090,Netherlands-France,2-0,2090,1982,0-2,4072,108,1.0544904137235116
2571,2018,11,16,Slovakia,Ukraine,4,1,European Nations League B,,1765,1772,Slovakia-Ukraine,4-1,1772,1765,1-4,3537,7,1.0039660056657225
2577,2018,11,16,Wales,Denmark,1,2,European Nations League B,,1775,1913,Wales-Denmark,1-2,1913,1775,2-1,3688,138,1.0777464788732394
2587,2018,11,17,Italy,Portugal,0,0,European Nations League A,,1883,1974,Italy-Portugal,0-0,1974,1883,0-0,3857,91,1.0483271375464684
2595,2018,11,17,Serbia,Montenegro,2,1,European Nations League C,,1805,1608,Serbia-Montenegro,2-1,1805,1608,2-1,3413,197,1.1225124378109452
2599,2018,11,17,Turkey,Sweden,0,1,European Nations League B,,1692,1835,Turkey-Sweden,0-1,1835,1692,1-0,3527,143,1.08451536643026
2606,2018,11,18,England,Croatia,2,1,European Nations League A,,1960,1925,England-Croatia,2-1,1960,1925,2-1,3885,35,1.018181818181818
2611,2018,11,18,Hungary,Finland,2,0,European Nations League C,,1611,1622,Hungary-Finland,2-0,1622,1611,0-2,3233,11,1.0068280571073867
2618,2018,11,18,Northern Ireland,Austria,1,2,European Nations League B,,1622,1765,Northern Ireland-Austria,1-2,1765,1622,2-1,3387,143,1.0881627620221948
2623,2018,11,18,Switzerland,Belgium,4,2,European Nations League A,,1922,2035,Switzerland-Belgium,4-2,2035,1922,2-4,3957,113,1.058792924037461
2630,2018,11,19,Czechia,Slovakia,1,0,European Nations League B,,1729,1748,Czechia-Slovakia,1-0,1748,1729,0-1,3477,19,1.010989010989011
2631,2018,11,19,Denmark,Ireland,0,0,European Nations League B,,1898,1704,Denmark-Ireland,0-0,1898,1704,0-0,3602,194,1.113849765258216
2633,2018,11,19,Germany,Netherlands,2,2,European Nations League A,,1938,1985,Germany-Netherlands,2-2,1985,1938,2-2,3923,47,1.024251805985552
2663,2018,11,20,Portugal,Poland,1,1,European Nations League A,,1959,1752,Portugal-Poland,1-1,1959,1752,1-1,3711,207,1.1181506849315068
2668,2018,11,20,Sweden,Russia,2,0,European Nations League B,,1852,1753,Sweden-Russia,2-0,1852,1753,2-0,3605,99,1.056474614945807
2742,2019,1,16,Iran,Iraq,0,0,Asian Cup,AE,1815,1612,Iran-Iraq,0-0,1815,1612,0-0,3427,203,1.1259305210918114
2746,2019,1,17,Japan,Uzbekistan,2,1,Asian Cup,AE,1761,1605,Japan-Uzbekistan,2-1,1761,1605,2-1,3366,156,1.097196261682243
2753,2019,1,21,Australia,Uzbekistan,0,0,Asian Cup,AE,1712,1613,Australia-Uzbekistan,0-0,1712,1613,0-0,3325,99,1.0613763174209547
2760,2019,1,25,Qatar,South Korea,1,0,Asian Cup,AE,1689,1767,Qatar-South Korea,1-0,1767,1689,0-1,3456,78,1.0461811722912966
2763,2019,1,28,Japan,Iran,3,0,Asian Cup,AE,1829,1789,Japan-Iran,3-0,1829,1789,3-0,3618,40,1.0223588596981554
2765,2019,2,1,Qatar,Japan,3,1,Asian Cup,AE,1774,1781,Qatar-Japan,3-1,1781,1774,1-3,3555,7,1.003945885005637
2798,2019,3,21,Austria,Poland,0,1,European Championship qualifier,,1739,1778,Austria-Poland,0-1,1778,1739,1-0,3517,39,1.02242668200115
2799,2019,3,21,Belgium,Russia,3,1,European Championship qualifier,,2041,1747,Belgium-Russia,3-1,2041,1747,3-1,3788,294,1.1682884945621064
2824,2019,3,22,England,Czechia,4,0,European Championship qualifier,,1970,1719,England-Czechia,4-0,1970,1719,4-0,3689,251,1.1460151250727166
2833,2019,3,22,Portugal,Ukraine,0,0,European Championship qualifier,,1945,1787,Portugal-Ukraine,0-0,1945,1787,0-0,3732,158,1.0884163402350309
2853,2019,3,23,Italy,Finland,2,0,European Championship qualifier,,1896,1616,Italy-Finland,2-0,1896,1616,2-0,3512,280,1.1732673267326732
2862,2019,3,23,Spain,Norway,2,1,European Championship qualifier,,2014,1675,Spain-Norway,2-1,2014,1675,2-1,3689,339,1.2023880597014924
2865,2019,3,23,Sweden,Romania,2,1,European Championship qualifier,,1843,1742,Sweden-Romania,2-1,1843,1742,2-1,3585,101,1.0579793340987371
2879,2019,3,24,Hungary,Croatia,2,1,European Championship qualifier,,1630,1895,Hungary-Croatia,2-1,1895,1630,1-2,3525,265,1.1625766871165644
2882,2019,3,24,Netherlands,Germany,2,3,European Championship qualifier,,1960,1960,Netherlands-Germany,2-3,1960,1960,2-3,3920,0,1.0
2891,2019,3,24,Wales,Slovakia,1,0,European Championship qualifier,,1776,1746,Wales-Slovakia,1-0,1776,1746,1-0,3522,30,1.0171821305841924
2896,2019,3,25,France,Iceland,4,0,European Championship qualifier,,2098,1667,France-Iceland,4-0,2098,1667,4-0,3765,431,1.2585482903419316
2902,2019,3,25,Portugal,Serbia,1,1,European Championship qualifier,,1933,1826,Portugal-Serbia,1-1,1933,1826,1-1,3759,107,1.0585980284775465
2908,2019,3,26,Bosnia and Herzegovina,Greece,2,2,European Championship qualifier,,1785,1632,Bosnia and Herzegovina-Greece,2-2,1785,1632,2-2,3417,153,1.09375
2925,2019,3,26,Norway,Sweden,3,3,European Championship qualifier,,1679,1839,Norway-Sweden,3-3,1839,1679,3-3,3518,160,1.0952948183442526
2929,2019,3,26,Switzerland,Denmark,3,3,European Championship qualifier,,1924,1899,Switzerland-Denmark,3-3,1924,1899,3-3,3823,25,1.013164823591364
2967,2019,6,5,Portugal,Switzerland,3,1,European Nations League,,1959,1898,Portugal-Switzerland,3-1,1959,1898,3-1,3857,61,1.0321390937829293
2979,2019,6,6,Netherlands,England,3,1,European Nations League,PT,2000,1943,Netherlands-England,3-1,2000,1943,3-1,3943,57,1.029336078229542
2984,2019,6,7,Czechia,Bulgaria,2,1,European Championship qualifier,,1725,1610,Czechia-Bulgaria,2-1,1725,1610,2-1,3335,115,1.0714285714285714
2985,2019,6,7,Denmark,Ireland,1,1,European Championship qualifier,,1885,1727,Denmark-Ireland,1-1,1885,1727,1-1,3612,158,1.0914881297046901
2998,2019,6,7,Norway,Romania,2,2,European Championship qualifier,,1677,1746,Norway-Romania,2-2,1746,1677,2-2,3423,69,1.0411449016100178
3005,2019,6,7,Ukraine,Serbia,4,0,European Championship qualifier,,1824,1794,Ukraine-Serbia,4-0,1824,1794,4-0,3618,30,1.0167224080267558
3013,2019,6,8,Croatia,Wales,2,1,European Championship qualifier,,1904,1767,Croatia-Wales,2-1,1904,1767,2-1,3671,137,1.0775325410299943
3016,2019,6,8,Finland,Bosnia and Herzegovina,2,0,European Championship qualifier,,1674,1751,Finland-Bosnia and Herzegovina,2-0,1751,1674,0-2,3425,77,1.0459976105137396
3017,2019,6,8,Greece,Italy,0,3,European Championship qualifier,,1608,1916,Greece-Italy,0-3,1916,1608,3-0,3524,308,1.191542288557214
3025,2019,6,8,Turkey,France,2,0,European Championship qualifier,,1780,2050,Turkey-France,2-0,2050,1780,0-2,3830,270,1.151685393258427
3030,2019,6,9,England,Switzerland,0,0,European Nations League,PT,1940,1901,England-Switzerland,0-0,1940,1901,0-0,3841,39,1.020515518148343
3036,2019,6,9,Portugal,Netherlands,1,0,European Nations League,,1980,1979,Portugal-Netherlands,1-0,1980,1979,1-0,3959,1,1.0005053057099544
3050,2019,6,10,Spain,Sweden,3,0,European Championship qualifier,,2028,1828,Spain-Sweden,3-0,2028,1828,3-0,3856,200,1.1094091903719911
3059,2019,6,11,Belgium,Scotland,3,0,European Championship qualifier,,2049,1666,Belgium-Scotland,3-0,2049,1666,3-0,3715,383,1.2298919567827131
3070,2019,6,11,Hungary,Wales,1,0,European Championship qualifier,,1670,1746,Hungary-Wales,1-0,1746,1670,0-1,3416,76,1.0455089820359282
3071,2019,6,11,Iceland,Turkey,2,1,European Championship qualifier,,1694,1760,Iceland-Turkey,2-1,1760,1694,1-2,3454,66,1.0389610389610389
3072,2019,6,11,Italy,Bosnia and Herzegovina,2,1,European Championship qualifier,,1923,1744,Italy-Bosnia and Herzegovina,2-1,1923,1744,2-1,3667,179,1.102637614678899
3084,2019,6,14,Brazil,Bolivia,3,0,Copa AmÃ©rica,,2137,1634,Brazil-Bolivia,3-0,2137,1634,3-0,3771,503,1.3078335373317014
3088,2019,6,15,Colombia,Argentina,2,0,Copa AmÃ©rica,BR,2004,1872,Colombia-Argentina,2-0,2004,1872,2-0,3876,132,1.0705128205128205
3093,2019,6,15,Peru,Venezuela,0,0,Copa AmÃ©rica,BR,1818,1788,Peru-Venezuela,0-0,1818,1788,0-0,3606,30,1.016778523489933
3100,2019,6,16,Paraguay,Qatar,2,2,Copa AmÃ©rica,BR,1712,1767,Paraguay-Qatar,2-2,1767,1712,2-2,3479,55,1.032126168224299
3103,2019,6,16,Uruguay,Ecuador,4,0,Copa AmÃ©rica,BR,1959,1728,Uruguay-Ecuador,4-0,1959,1728,4-0,3687,231,1.1336805555555556
3104,2019,6,17,Chile,Japan,4,0,Copa AmÃ©rica,BR,1874,1734,Chile-Japan,4-0,1874,1734,4-0,3608,140,1.0807381776239908
3109,2019,6,18,Brazil,Venezuela,0,0,Copa AmÃ©rica,,2116,1809,Brazil-Venezuela,0-0,2116,1809,0-0,3925,307,1.1697070204532891
3111,2019,6,18,Peru,Bolivia,3,1,Copa AmÃ©rica,BR,1837,1615,Peru-Bolivia,3-1,1837,1615,3-1,3452,222,1.1374613003095975
3113,2019,6,19,Argentina,Paraguay,1,1,Copa AmÃ©rica,BR,1861,1723,Argentina-Paraguay,1-1,1861,1723,1-1,3584,138,1.0800928612884504
3114,2019,6,19,Colombia,Qatar,1,0,Copa AmÃ©rica,BR,2014,1757,Colombia-Qatar,1-0,2014,1757,1-0,3771,257,1.1462720546385885
3120,2019,6,20,Japan,Uruguay,2,2,Copa AmÃ©rica,BR,1748,1945,Japan-Uruguay,2-2,1945,1748,2-2,3693,197,1.112700228832952
3121,2019,6,21,Chile,Ecuador,2,1,Copa AmÃ©rica,BR,1889,1713,Chile-Ecuador,2-1,1889,1713,2-1,3602,176,1.1027437244600116
3125,2019,6,22,Brazil,Peru,4,0,Copa AmÃ©rica,,2126,1827,Brazil-Peru,4-0,2126,1827,4-0,3953,299,1.163656267104543
3133,2019,6,23,Argentina,Qatar,2,0,Copa AmÃ©rica,BR,1888,1730,Argentina-Qatar,2-0,1888,1730,2-0,3618,158,1.091329479768786
3135,2019,6,23,Colombia,Paraguay,1,0,Copa AmÃ©rica,BR,2022,1715,Colombia-Paraguay,1-0,2022,1715,1-0,3737,307,1.179008746355685
3141,2019,6,24,Ecuador,Japan,1,1,Copa AmÃ©rica,BR,1716,1745,Ecuador-Japan,1-1,1745,1716,1-1,3461,29,1.0168997668997668
3145,2019,6,24,Uruguay,Chile,1,0,Copa AmÃ©rica,BR,1966,1868,Uruguay-Chile,1-0,1966,1868,1-0,3834,98,1.0524625267665952
3155,2019,6,27,Algeria,Senegal,1,0,African Nations Cup,EG,1606,1740,Algeria-Senegal,1-0,1740,1606,0-1,3346,134,1.083437110834371
3156,2019,6,27,Brazil,Paraguay,0,0,Copa AmÃ©rica,,2104,1737,Brazil-Paraguay,0-0,2104,1737,0-0,3841,367,1.2112838226827864
3159,2019,6,28,Argentina,Venezuela,2,0,Copa AmÃ©rica,BR,1919,1796,Argentina-Venezuela,2-0,1919,1796,2-0,3715,123,1.0684855233853006
3160,2019,6,28,Chile,Colombia,0,0,Copa AmÃ©rica,BR,1878,2012,Chile-Colombia,0-0,2012,1878,0-0,3890,134,1.071352502662407
3162,2019,6,28,Morocco,Ivory Coast,1,0,African Nations Cup,EG,1698,1607,Morocco-Ivory Coast,1-0,1698,1607,1-0,3305,91,1.0566272557560672
3166,2019,6,29,Cameroon,Ghana,0,0,African Nations Cup,EG,1615,1603,Cameroon-Ghana,0-0,1615,1603,0-0,3218,12,1.0074859638178415
3167,2019,6,29,Costa Rica,Mexico,1,1,CONCACAF Championship,US,1685,1850,Costa Rica-Mexico,1-1,1850,1685,1-1,3535,165,1.0979228486646884
3169,2019,6,29,Peru,Uruguay,0,0,Copa AmÃ©rica,BR,1837,1956,Peru-Uruguay,0-0,1956,1837,0-0,3793,119,1.0647795318454
3181,2019,7,2,Brazil,Argentina,2,0,Copa AmÃ©rica,,2116,1907,Brazil-Argentina,2-0,2116,1907,2-0,4023,209,1.1095962244362874
3186,2019,7,3,Peru,Chile,3,0,Copa AmÃ©rica,BR,1886,1829,Peru-Chile,3-0,1886,1829,3-0,3715,57,1.0311645708037178
3190,2019,7,6,Argentina,Chile,2,1,Copa AmÃ©rica,BR,1926,1810,Argentina-Chile,2-1,1926,1810,2-1,3736,116,1.0640883977900553
3194,2019,7,7,Brazil,Peru,3,1,Copa AmÃ©rica,,2126,1876,Brazil-Peru,3-1,2126,1876,3-1,4002,250,1.1332622601279319
3197,2019,7,7,United States,Mexico,0,1,CONCACAF Championship,,1739,1885,United States-Mexico,0-1,1885,1739,1-0,3624,146,1.0839562967222542
3199,2019,7,8,Ghana,Tunisia,1,1,African Nations Cup,EG,1615,1627,Ghana-Tunisia,1-1,1627,1615,1-1,3242,12,1.0074303405572755
3212,2019,7,11,Algeria,Ivory Coast,1,1,African Nations Cup,EG,1645,1644,Algeria-Ivory Coast,1-1,1645,1644,1-1,3289,1,1.0006082725060828
3219,2019,7,14,Algeria,Nigeria,2,1,African Nations Cup,EG,1673,1661,Algeria-Nigeria,2-1,1673,1661,2-1,3334,12,1.0072245635159542
3220,2019,7,14,Senegal,Tunisia,1,0,African Nations Cup,EG,1784,1631,Senegal-Tunisia,1-0,1784,1631,1-0,3415,153,1.0938074800735744
3227,2019,7,17,Nigeria,Tunisia,1,0,African Nations Cup,EG,1684,1608,Nigeria-Tunisia,1-0,1684,1608,1-0,3292,76,1.0472636815920398
3236,2019,7,19,Algeria,Senegal,1,0,African Nations Cup,EG,1706,1751,Algeria-Senegal,1-0,1751,1706,0-1,3457,45,1.026377491207503
3309,2019,9,5,Ireland,Switzerland,1,1,European Championship qualifier,,1732,1897,Ireland-Switzerland,1-1,1897,1732,1-1,3629,165,1.0952655889145497
3322,2019,9,5,Romania,Spain,1,2,European Championship qualifier,,1740,2039,Romania-Spain,1-2,2039,1740,2-1,3779,299,1.17183908045977
3341,2019,9,6,Germany,Netherlands,2,3,European Championship qualifier,,1933,2017,Germany-Netherlands,2-3,2017,1933,3-2,3950,84,1.0434557682359027
3347,2019,9,6,Scotland,Russia,1,2,European Championship qualifier,,1646,1784,Scotland-Russia,1-2,1784,1646,2-1,3430,138,1.0838396111786148
3348,2019,9,6,Slovakia,Croatia,0,3,European Championship qualifier,,1728,1921,Slovakia-Croatia,0-3,1921,1728,3-0,3649,193,1.1116898148148149
3349,2019,9,6,Slovenia,Poland,2,0,European Championship qualifier,,1613,1763,Slovenia-Poland,2-0,1763,1613,0-2,3376,150,1.09299442033478
3365,2019,9,7,Serbia,Portugal,2,3,European Championship qualifier,,1774,2003,Serbia-Portugal,2-3,2003,1774,3-2,3777,229,1.129086809470124
3371,2019,9,8,Finland,Italy,1,2,European Championship qualifier,,1675,1942,Finland-Italy,1-2,1942,1675,2-1,3617,267,1.1594029850746268
3383,2019,9,8,Sweden,Norway,1,1,European Championship qualifier,,1820,1698,Sweden-Norway,1-1,1820,1698,1-1,3518,122,1.071849234393404
3393,2019,9,9,Hungary,Slovakia,1,2,European Championship qualifier,,1638,1750,Hungary-Slovakia,1-2,1750,1638,2-1,3388,112,1.0683760683760684
3396,2019,9,9,Northern Ireland,Germany,0,2,European Championship qualifier,,1662,1951,Northern Ireland-Germany,0-2,1951,1662,2-0,3613,289,1.1738868832731648
3397,2019,9,9,Poland,Austria,0,0,European Championship qualifier,,1756,1746,Poland-Austria,0-0,1756,1746,0-0,3502,10,1.0057273768613975
3400,2019,9,9,Scotland,Belgium,0,3,European Championship qualifier,,1635,2060,Scotland-Belgium,0-3,2060,1635,3-0,3695,425,1.2599388379204892
3482,2019,10,10,Croatia,Hungary,3,0,European Championship qualifier,,1912,1630,Croatia-Hungary,3-0,1912,1630,3-0,3542,282,1.173006134969325
3494,2019,10,10,Netherlands,Northern Ireland,3,1,European Championship qualifier,,2025,1658,Netherlands-Northern Ireland,3-1,2025,1658,3-1,3683,367,1.221351025331725
3498,2019,10,10,Russia,Scotland,4,0,European Championship qualifier,,1800,1621,Russia-Scotland,4-0,1800,1621,4-0,3421,179,1.1104256631708822
3501,2019,10,10,Slovakia,Wales,1,1,European Championship qualifier,,1744,1757,Slovakia-Wales,1-1,1757,1744,1-1,3501,13,1.007454128440367
3514,2019,10,11,Czechia,England,2,1,European Championship qualifier,,1770,1923,Czechia-England,2-1,1923,1770,1-2,3693,153,1.0864406779661018
3515,2019,10,11,Iceland,France,0,1,European Championship qualifier,,1654,2058,Iceland-France,0-1,2058,1654,1-0,3712,404,1.2442563482466746
3527,2019,10,12,Bosnia and Herzegovina,Finland,4,1,European Championship qualifier,,1723,1652,Bosnia and Herzegovina-Finland,4-1,1723,1652,4-1,3375,71,1.0429782082324455
3530,2019,10,12,Denmark,Switzerland,1,0,European Championship qualifier,,1894,1882,Denmark-Switzerland,1-0,1894,1882,1-0,3776,12,1.006376195536663
3539,2019,10,12,Norway,Spain,1,1,European Championship qualifier,,1710,2027,Norway-Spain,1-1,2027,1710,1-1,3737,317,1.1853801169590643
3570,2019,10,13,Wales,Croatia,1,1,European Championship qualifier,,1760,1909,Wales-Croatia,1-1,1909,1760,1-1,3669,149,1.084659090909091
3575,2019,10,14,France,Turkey,1,1,European Championship qualifier,,2042,1789,France-Turkey,1-1,2042,1789,1-1,3831,253,1.141419787590833
3584,2019,10,14,Ukraine,Portugal,2,1,European Championship qualifier,,1851,1982,Ukraine-Portugal,2-1,1982,1851,1-2,3833,131,1.0707725553754728
3592,2019,10,15,Canada,United States,2,0,CONCACAF Nations League A,,1624,1697,Canada-United States,2-0,1697,1624,0-2,3321,73,1.0449507389162562
3617,2019,10,15,Romania,Norway,1,1,European Championship qualifier,,1739,1718,Romania-Norway,1-1,1739,1718,1-1,3457,21,1.0122235157159487
3621,2019,10,15,Sweden,Spain,1,1,European Championship qualifier,,1829,2021,Sweden-Spain,1-1,2021,1829,1-1,3850,192,1.1049753963914708
3622,2019,10,15,Switzerland,Ireland,2,0,European Championship qualifier,,1894,1721,Switzerland-Ireland,2-0,1894,1721,2-0,3615,173,1.1005229517722255
3664,2019,11,14,Iraq,Iran,2,1,World Cup and Asian Cup qualifier,JO,1603,1739,Iraq-Iran,2-1,1739,1603,1-2,3342,136,1.084840923268871
3683,2019,11,14,Turkey,Iceland,0,0,European Championship qualifier,,1777,1667,Turkey-Iceland,0-0,1777,1667,0-0,3444,110,1.065986802639472
3693,2019,11,15,Bosnia and Herzegovina,Italy,0,3,European Championship qualifier,,1678,1967,Bosnia and Herzegovina-Italy,0-3,1967,1678,3-0,3645,289,1.17222884386174
3702,2019,11,15,Romania,Sweden,0,2,European Championship qualifier,,1708,1860,Romania-Sweden,0-2,1860,1708,2-0,3568,152,1.088992974238876
3709,2019,11,15,United States,Canada,4,1,CONCACAF Nations League A,,1716,1605,United States-Canada,4-1,1716,1605,4-1,3321,111,1.0691588785046728
3714,2019,11,16,Croatia,Slovakia,3,1,European Championship qualifier,,1920,1730,Croatia-Slovakia,3-1,1920,1730,3-1,3650,190,1.1098265895953756
3722,2019,11,16,Northern Ireland,Netherlands,0,0,European Championship qualifier,,1686,2015,Northern Ireland-Netherlands,0-0,2015,1686,0-0,3701,329,1.1951364175563464
3723,2019,11,16,Russia,Belgium,1,3,European Championship qualifier,,1793,2083,Russia-Belgium,1-3,2083,1793,3-1,3876,290,1.161740100390407
3750,2019,11,17,Serbia,Ukraine,2,2,European Championship qualifier,,1792,1854,Serbia-Ukraine,2-2,1854,1792,2-2,3646,62,1.0345982142857142
3761,2019,11,18,Greece,Finland,2,1,European Championship qualifier,,1608,1647,Greece-Finland,2-1,1647,1608,1-2,3255,39,1.0242537313432836
3762,2019,11,18,Ireland,Denmark,1,1,European Championship qualifier,,1729,1891,Ireland-Denmark,1-1,1891,1729,1-1,3620,162,1.0936957779063041
3770,2019,11,18,Spain,Romania,4,0,European Championship qualifier,,2028,1701,Spain-Romania,4-0,2028,1701,4-0,3729,327,1.1922398589065255
3782,2019,11,19,Germany,Northern Ireland,4,1,European Championship qualifier,,1965,1678,Germany-Northern Ireland,4-1,1965,1678,4-1,3643,287,1.1710369487485102
3816,2019,11,19,Wales,Hungary,2,0,European Championship qualifier,,1783,1619,Wales-Hungary,2-0,1783,1619,2-0,3402,164,1.1012970969734404
3819,2019,11,26,Qatar,Iraq,1,2,Gulf Cup,,1691,1628,Qatar-Iraq,1-2,1691,1628,1-2,3319,63,1.0386977886977886
3857,2019,12,18,South Korea,Japan,1,0,East Asian Championship,,1771,1744,South Korea-Japan,1-0,1771,1744,1-0,3515,27,1.0154816513761469
3887,2020,9,3,Turkey,Hungary,0,1,European Nations League B,,1746,1652,Turkey-Hungary,0-1,1746,1652,0-1,3398,94,1.0569007263922519
3888,2020,9,3,Russia,Serbia,3,1,European Nations League B,,1815,1771,Russia-Serbia,3-1,1815,1771,3-1,3586,44,1.0248447204968945
3889,2020,9,3,Finland,Wales,0,1,European Nations League B,,1629,1801,Finland-Wales,0-1,1801,1629,1-0,3430,172,1.105586249232658
3891,2020,9,3,Ukraine,Switzerland,2,1,European Nations League A,,1871,1881,Ukraine-Switzerland,2-1,1881,1871,1-2,3752,10,1.005344735435596
3892,2020,9,3,Germany,Spain,1,1,European Nations League A,,1963,2030,Germany-Spain,1-1,2030,1963,1-1,3993,67,1.0341314314824248
3895,2020,9,4,Slovakia,Czechia,1,3,European Nations League B,,1696,1774,Slovakia-Czechia,1-3,1774,1696,3-1,3470,78,1.0459905660377358
3897,2020,9,4,Romania,Northern Ireland,1,1,European Nations League B,,1694,1685,Romania-Northern Ireland,1-1,1694,1685,1-1,3379,9,1.0053412462908011
3898,2020,9,4,Norway,Austria,1,2,European Nations League B,,1698,1766,Norway-Austria,1-2,1766,1698,2-1,3464,68,1.0400471142520613
3899,2020,9,4,Netherlands,Poland,1,0,European Nations League A,,2022,1785,Netherlands-Poland,1-0,2022,1785,1-0,3807,237,1.1327731092436975
3900,2020,9,4,Italy,Bosnia and Herzegovina,1,1,European Nations League A,,1954,1699,Italy-Bosnia and Herzegovina,1-1,1954,1699,1-1,3653,255,1.1500882872277811
3906,2020,9,5,Sweden,France,0,1,European Nations League A,,1850,2062,Sweden-France,0-1,2062,1850,1-0,3912,212,1.1145945945945945
3907,2020,9,5,Portugal,Croatia,4,1,European Nations League A,,2006,1901,Portugal-Croatia,4-1,2006,1901,4-1,3907,105,1.055234087322462
3908,2020,9,5,Iceland,England,0,1,European Nations League A,,1674,1967,Iceland-England,0-1,1967,1674,1-0,3641,293,1.1750298685782556
3909,2020,9,5,Denmark,Belgium,0,2,European Nations League A,,1869,2106,Denmark-Belgium,0-2,2106,1869,2-0,3975,237,1.1268057784911718
3915,2020,9,6,Serbia,Turkey,0,0,European Nations League B,,1764,1753,Serbia-Turkey,0-0,1764,1753,0-0,3517,11,1.0062749572162009
3916,2020,9,6,Ireland,Finland,0,1,European Nations League B,,1695,1659,Ireland-Finland,0-1,1695,1659,0-1,3354,36,1.0216998191681737
3917,2020,9,6,Hungary,Russia,2,3,European Nations League B,,1636,1831,Hungary-Russia,2-3,1831,1636,3-2,3467,195,1.11919315403423
3918,2020,9,6,Switzerland,Germany,1,1,European Nations League A,,1880,1964,Switzerland-Germany,1-1,1964,1880,1-1,3844,84,1.0446808510638297
3919,2020,9,6,Spain,Ukraine,4,0,European Nations League A,,2044,1857,Spain-Ukraine,4-0,2044,1857,4-0,3901,187,1.1007000538502962
3922,2020,9,7,Northern Ireland,Norway,1,3,European Nations League B,,1638,1745,Northern Ireland-Norway,1-3,1745,1638,3-1,3383,107,1.0653235653235653
3924,2020,9,7,Czechia,Scotland,1,2,European Nations League B,,1742,1662,Czechia-Scotland,1-2,1742,1662,1-2,3404,80,1.0481347773766547
3925,2020,9,7,Austria,Romania,2,3,European Nations League B,,1737,1723,Austria-Romania,2-3,1737,1723,2-3,3460,14,1.008125362739408
3926,2020,9,7,Netherlands,Italy,0,1,European Nations League A,,1993,1983,Netherlands-Italy,0-1,1993,1983,0-1,3976,10,1.0050428643469491
3927,2020,9,7,Bosnia and Herzegovina,Poland,1,2,European Nations League A,,1678,1806,Bosnia and Herzegovina-Poland,1-2,1806,1678,2-1,3484,128,1.0762812872467222
3933,2020,9,8,Sweden,Portugal,0,2,European Nations League A,,1825,2031,Sweden-Portugal,0-2,2031,1825,2-0,3856,206,1.112876712328767
3934,2020,9,8,France,Croatia,4,2,European Nations League A,,2073,1890,France-Croatia,4-2,2073,1890,4-2,3963,183,1.096825396825397
3935,2020,9,8,Denmark,England,0,0,European Nations League A,,1869,1967,Denmark-England,0-0,1967,1869,0-0,3836,98,1.0524344569288389
3936,2020,9,8,Belgium,Iceland,4,1,European Nations League A,,2109,1671,Belgium-Iceland,4-1,2109,1671,4-1,3780,438,1.2621184919210053
3964,2020,10,8,Slovakia,Ireland,0,0,European Championship qualifier,,1688,1700,Slovakia-Ireland,0-0,1700,1688,0-0,3388,12,1.0071090047393365
3966,2020,10,8,Norway,Serbia,1,2,European Championship qualifier,,1720,1789,Norway-Serbia,1-2,1789,1720,2-1,3509,69,1.0401162790697673
3968,2020,10,8,Iceland,Romania,2,1,European Championship qualifier,,1688,1706,Iceland-Romania,2-1,1706,1688,1-2,3394,18,1.0106635071090047
3971,2020,10,8,Bosnia and Herzegovina,Northern Ireland,1,1,European Championship qualifier,,1670,1646,Bosnia and Herzegovina-Northern Ireland,1-1,1670,1646,1-1,3316,24,1.014580801944107
3972,2020,10,8,Uruguay,Chile,2,1,World Cup qualifier,,1973,1800,Uruguay-Chile,2-1,1973,1800,2-1,3773,173,1.096111111111111
3973,2020,10,8,Paraguay,Peru,2,2,World Cup qualifier,,1740,1864,Paraguay-Peru,2-2,1864,1740,2-2,3604,124,1.071264367816092
3974,2020,10,8,Argentina,Ecuador,1,0,World Cup qualifier,,1972,1721,Argentina-Ecuador,1-0,1972,1721,1-0,3693,251,1.1458454386984311
3984,2020,10,9,Colombia,Venezuela,3,0,World Cup qualifier,,1998,1816,Colombia-Venezuela,3-0,1998,1816,3-0,3814,182,1.1002202643171806
3995,2020,10,10,Ukraine,Germany,1,2,European Nations League A,,1831,1977,Ukraine-Germany,1-2,1977,1831,2-1,3808,146,1.0797378481703988
3996,2020,10,10,Spain,Switzerland,1,0,European Nations League A,,2053,1860,Spain-Switzerland,1-0,2053,1860,1-0,3913,193,1.103763440860215
4008,2020,10,11,Serbia,Hungary,0,1,European Nations League B,,1758,1699,Serbia-Hungary,0-1,1758,1699,0-1,3457,59,1.0347263095938788
4009,2020,10,11,Scotland,Slovakia,1,0,European Nations League B,,1667,1672,Scotland-Slovakia,1-0,1672,1667,0-1,3339,5,1.002999400119976
4010,2020,10,11,Russia,Turkey,1,1,European Nations League B,,1809,1769,Russia-Turkey,1-1,1809,1769,1-1,3578,40,1.0226116449971736
4011,2020,10,11,Northern Ireland,Austria,0,1,European Nations League B,,1626,1762,Northern Ireland-Austria,0-1,1762,1626,1-0,3388,136,1.083640836408364
4012,2020,10,11,Norway,Romania,4,0,European Nations League B,,1746,1680,Norway-Romania,4-0,1746,1680,4-0,3426,66,1.0392857142857144
4014,2020,10,11,Ireland,Wales,0,0,European Nations League B,,1700,1800,Ireland-Wales,0-0,1800,1700,0-0,3500,100,1.0588235294117647
4016,2020,10,11,Poland,Italy,0,0,European Nations League A,,1817,1979,Poland-Italy,0-0,1979,1817,0-0,3796,162,1.089157952669235
4017,2020,10,11,Iceland,Denmark,0,3,European Nations League A,,1661,1897,Iceland-Denmark,0-3,1897,1661,3-0,3558,236,1.1420830824804336
4018,2020,10,11,France,Portugal,0,0,European Nations League A,,2071,2037,France-Portugal,0-0,2071,2037,0-0,4108,34,1.0166912125675012
4019,2020,10,11,England,Belgium,2,1,European Nations League A,,1995,2078,England-Belgium,2-1,2078,1995,1-2,4073,83,1.0416040100250628
4020,2020,10,11,Croatia,Sweden,2,1,European Nations League A,,1914,1827,Croatia-Sweden,2-1,1914,1827,2-1,3741,87,1.0476190476190477
4021,2020,10,11,Bosnia and Herzegovina,Netherlands,0,0,European Nations League A,,1681,1967,Bosnia and Herzegovina-Netherlands,0-0,1967,1681,0-0,3648,286,1.1701368233194527
4038,2020,10,13,Ukraine,Spain,1,0,European Nations League A,,1858,2026,Ukraine-Spain,1-0,2026,1858,0-1,3884,168,1.0904198062432724
4039,2020,10,13,Germany,Switzerland,3,3,European Nations League A,,1966,1871,Germany-Switzerland,3-3,1966,1871,3-3,3837,95,1.0507749866381615
4040,2020,10,13,Venezuela,Paraguay,0,1,World Cup qualifier,,1787,1769,Venezuela-Paraguay,0-1,1787,1769,0-1,3556,18,1.010175240248728
4041,2020,10,13,Peru,Brazil,2,3,World Cup qualifier,,1844,2105,Peru-Brazil,2-3,2105,1844,3-2,3949,261,1.1415401301518437
4042,2020,10,13,Ecuador,Uruguay,4,2,World Cup qualifier,,1763,1931,Ecuador-Uruguay,4-2,1931,1763,2-4,3694,168,1.0952921157118547
4043,2020,10,13,Chile,Colombia,2,2,World Cup qualifier,,1805,1993,Chile-Colombia,2-2,1993,1805,2-2,3798,188,1.1041551246537396
4051,2020,10,14,Turkey,Serbia,2,2,European Nations League B,,1763,1764,Turkey-Serbia,2-2,1764,1763,2-2,3527,1,1.0005672149744753
4053,2020,10,14,Scotland,Czechia,1,0,European Nations League B,,1687,1740,Scotland-Czechia,1-0,1740,1687,0-1,3427,53,1.031416716064019
4054,2020,10,14,Russia,Hungary,0,0,European Nations League B,,1798,1710,Russia-Hungary,0-0,1798,1710,0-0,3508,88,1.0514619883040937
4055,2020,10,14,Romania,Austria,0,1,European Nations League B,,1659,1783,Romania-Austria,0-1,1783,1659,1-0,3442,124,1.0747438215792646
4056,2020,10,14,Norway,Northern Ireland,1,0,European Nations League B,,1755,1617,Norway-Northern Ireland,1-0,1755,1617,1-0,3372,138,1.085343228200371
4057,2020,10,14,Finland,Ireland,1,0,European Nations League B,,1681,1684,Finland-Ireland,1-0,1684,1681,0-1,3365,3,1.0017846519928615
4059,2020,10,14,Portugal,Sweden,3,0,European Nations League A,,2047,1817,Portugal-Sweden,3-0,2047,1817,3-0,3864,230,1.1265822784810127
4060,2020,10,14,Poland,Bosnia and Herzegovina,3,0,European Nations League A,,1831,1667,Poland-Bosnia and Herzegovina,3-0,1831,1667,3-0,3498,164,1.098380323935213
4061,2020,10,14,Italy,Netherlands,1,1,European Nations League A,,1973,1973,Italy-Netherlands,1-1,1973,1973,1-1,3946,0,1.0
4062,2020,10,14,Iceland,Belgium,1,2,European Nations League A,,1655,2084,Iceland-Belgium,1-2,2084,1655,2-1,3739,429,1.259214501510574
4063,2020,10,14,England,Denmark,0,1,European Nations League A,,1965,1927,England-Denmark,0-1,1965,1927,0-1,3892,38,1.0197197716658017
4064,2020,10,14,Croatia,France,1,2,European Nations League A,,1897,2088,Croatia-France,1-2,2088,1897,2-1,3985,191,1.1006852925672115
4111,2020,11,12,Serbia,Scotland,1,1,European Championship qualifier,,1755,1696,Serbia-Scotland,1-1,1755,1696,1-1,3451,59,1.0347877358490567
4113,2020,11,12,Hungary,Iceland,2,1,European Championship qualifier,,1722,1643,Hungary-Iceland,2-1,1722,1643,2-1,3365,79,1.048082775410834
4116,2020,11,12,Argentina,Paraguay,1,1,World Cup qualifier,,1965,1783,Argentina-Paraguay,1-1,1965,1783,1-1,3748,182,1.1020751542344362
4126,2020,11,13,Colombia,Uruguay,0,3,World Cup qualifier,,1943,1981,Colombia-Uruguay,0-3,1981,1943,3-0,3924,38,1.0195573854863613
4127,2020,11,13,Chile,Peru,2,0,World Cup qualifier,,1830,1819,Chile-Peru,2-0,1830,1819,2-0,3649,11,1.006047278724574
4128,2020,11,13,Brazil,Venezuela,1,0,World Cup qualifier,,2108,1784,Brazil-Venezuela,1-0,2108,1784,1-0,3892,324,1.1816143497757847
4139,2020,11,14,Switzerland,Spain,1,1,European Nations League A,,1871,2024,Switzerland-Spain,1-1,2024,1871,1-1,3895,153,1.0817744521646178
4140,2020,11,14,Sweden,Croatia,2,1,European Nations League A,,1829,1877,Sweden-Croatia,2-1,1877,1829,1-2,3706,48,1.0262438490978676
4141,2020,11,14,Portugal,France,0,1,European Nations League A,,2022,2085,Portugal-France,0-1,2085,2022,1-0,4107,63,1.0311572700296736
4142,2020,11,14,Germany,Ukraine,3,1,European Nations League A,,1982,1833,Germany-Ukraine,3-1,1982,1833,3-1,3815,149,1.0812875068194217
4155,2020,11,15,Wales,Ireland,1,0,European Nations League B,,1814,1671,Wales-Ireland,1-0,1814,1671,1-0,3485,143,1.08557749850389
4156,2020,11,15,Turkey,Russia,3,2,European Nations League B,,1780,1773,Turkey-Russia,3-2,1780,1773,3-2,3553,7,1.0039481105470953
4157,2020,11,15,Slovakia,Scotland,1,0,European Nations League B,,1681,1680,Slovakia-Scotland,1-0,1681,1680,1-0,3361,1,1.000595238095238
4158,2020,11,15,Hungary,Serbia,1,1,European Nations League B,,1718,1759,Hungary-Serbia,1-1,1759,1718,1-1,3477,41,1.0238649592549476
4162,2020,11,15,Netherlands,Bosnia and Herzegovina,3,1,European Nations League A,,1977,1646,Netherlands-Bosnia and Herzegovina,3-1,1977,1646,3-1,3623,331,1.201093560145808
4163,2020,11,15,Italy,Poland,2,0,European Nations League A,,1987,1830,Italy-Poland,2-0,1987,1830,2-0,3817,157,1.0857923497267759
4164,2020,11,15,Denmark,Iceland,2,1,European Nations League A,,1938,1639,Denmark-Iceland,2-1,1938,1639,2-1,3577,299,1.1824283099450885
4165,2020,11,15,Belgium,England,2,0,European Nations League A,,2100,1956,Belgium-England,2-0,2100,1956,2-0,4056,144,1.0736196319018405
4198,2020,11,17,Spain,Germany,4,0,European Nations League A,,2050,1956,Spain-Germany,4-0,2050,1956,4-0,4006,94,1.0480572597137015
4199,2020,11,17,France,Sweden,4,2,European Nations League A,,2092,1822,France-Sweden,4-2,2092,1822,4-2,3914,270,1.1481888035126235
4200,2020,11,17,Croatia,Portugal,2,3,European Nations League A,,1860,2039,Croatia-Portugal,2-3,2039,1860,3-2,3899,179,1.096236559139785
4201,2020,11,17,Venezuela,Chile,2,1,World Cup qualifier,,1801,1813,Venezuela-Chile,2-1,1813,1801,1-2,3614,12,1.0066629650194336
4202,2020,11,17,Uruguay,Brazil,0,2,World Cup qualifier,,1953,2136,Uruguay-Brazil,0-2,2136,1953,2-0,4089,183,1.0937019969278035
4203,2020,11,17,Peru,Argentina,0,2,World Cup qualifier,,1793,1991,Peru-Argentina,0-2,1991,1793,2-0,3784,198,1.1104294478527608
4205,2020,11,17,Ecuador,Colombia,4,1,World Cup qualifier,,1826,1896,Ecuador-Colombia,4-1,1896,1826,1-4,3722,70,1.0383351588170866
4208,2020,11,18,Greece,Slovenia,0,0,European Nations League C,,1627,1628,Greece-Slovenia,0-0,1628,1627,0-0,3255,1,1.0006146281499693
4212,2020,11,18,Wales,Finland,3,1,European Nations League B,,1829,1708,Wales-Finland,3-1,1829,1708,3-1,3537,121,1.0708430913348945
4213,2020,11,18,Serbia,Russia,4,0,European Nations League B,,1789,1743,Serbia-Russia,4-0,1789,1743,4-0,3532,46,1.0263912794033276
4217,2020,11,18,Hungary,Turkey,2,0,European Nations League B,,1745,1753,Hungary-Turkey,2-0,1753,1745,0-2,3498,8,1.0045845272206304
4218,2020,11,18,Czechia,Slovakia,2,0,European Nations League B,,1761,1664,Czechia-Slovakia,2-0,1761,1664,2-0,3425,97,1.0582932692307692
4219,2020,11,18,Austria,Norway,1,1,European Nations League B,,1786,1763,Austria-Norway,1-1,1786,1763,1-1,3549,23,1.0130459444129325
4220,2020,11,18,Poland,Netherlands,1,2,European Nations League A,,1813,1994,Poland-Netherlands,1-2,1994,1813,2-1,3807,181,1.099834528405957
4221,2020,11,18,England,Iceland,4,0,European Nations League A,,1962,1633,England-Iceland,4-0,1962,1633,4-0,3595,329,1.2014696876913655
4222,2020,11,18,Bosnia and Herzegovina,Italy,0,2,European Nations League A,,1634,1999,Bosnia and Herzegovina-Italy,0-2,1999,1634,2-0,3633,365,1.2233782129742963
4223,2020,11,18,Belgium,Denmark,4,2,European Nations League A,,2111,1927,Belgium-Denmark,4-2,2111,1927,4-2,4038,184,1.0954852101712507
4257,2021,3,24,Turkey,Netherlands,4,2,World Cup qualifier,,1795,1952,Turkey-Netherlands,4-2,1952,1795,2-4,3747,157,1.0874651810584959
4258,2021,3,24,Slovenia,Croatia,1,0,World Cup qualifier,,1655,1833,Slovenia-Croatia,1-0,1833,1655,0-1,3488,178,1.1075528700906345
4259,2021,3,24,Serbia,Ireland,3,2,World Cup qualifier,,1785,1649,Serbia-Ireland,3-2,1785,1649,3-2,3434,136,1.0824742268041236
4264,2021,3,24,France,Ukraine,1,1,World Cup qualifier,,2076,1849,France-Ukraine,1-1,2076,1849,1-1,3925,227,1.122769064359113
4265,2021,3,24,Finland,Bosnia and Herzegovina,2,2,World Cup qualifier,,1699,1643,Finland-Bosnia and Herzegovina,2-2,1699,1643,2-2,3342,56,1.0340839926962873
4268,2021,3,24,Belgium,Wales,3,1,World Cup qualifier,,2117,1823,Belgium-Wales,3-1,2117,1823,3-1,3940,294,1.1612726275370269
4290,2021,3,25,Spain,Greece,1,1,World Cup qualifier,,2032,1645,Spain-Greece,1-1,2032,1645,1-1,3677,387,1.235258358662614
4291,2021,3,25,Scotland,Austria,2,2,World Cup qualifier,,1661,1785,Scotland-Austria,2-2,1785,1661,2-2,3446,124,1.074653822998194
4297,2021,3,25,Hungary,Poland,3,3,World Cup qualifier,,1743,1815,Hungary-Poland,3-3,1815,1743,3-3,3558,72,1.0413080895008606
4298,2021,3,25,Germany,Iceland,3,0,World Cup qualifier,,1962,1627,Germany-Iceland,3-0,1962,1627,3-0,3589,335,1.205900430239705
4322,2021,3,27,Serbia,Portugal,2,2,World Cup qualifier,,1793,2032,Serbia-Portugal,2-2,2032,1793,2-2,3825,239,1.1332961517010596
4323,2021,3,27,Russia,Slovenia,2,1,World Cup qualifier,,1758,1645,Russia-Slovenia,2-1,1758,1645,2-1,3403,113,1.068693009118541
4324,2021,3,27,Norway,Turkey,0,3,World Cup qualifier,ES,1734,1827,Norway-Turkey,0-3,1827,1734,3-0,3561,93,1.0536332179930796
4328,2021,3,27,Czechia,Belgium,1,1,World Cup qualifier,,1781,2105,Czechia-Belgium,1-1,2105,1781,1-1,3886,324,1.1819202695115103
4344,2021,3,28,Ukraine,Finland,1,1,World Cup qualifier,,1837,1711,Ukraine-Finland,1-1,1837,1711,1-1,3548,126,1.0736411455289305
4347,2021,3,28,Romania,Germany,0,1,World Cup qualifier,,1666,1972,Romania-Germany,0-1,1972,1666,1-0,3638,306,1.183673469387755
4392,2021,3,30,Wales,Czechia,1,0,World Cup qualifier,,1845,1769,Wales-Czechia,1-0,1845,1769,1-0,3614,76,1.0429621254946297
4394,2021,3,30,Slovakia,Russia,2,1,World Cup qualifier,,1655,1737,Slovakia-Russia,2-1,1737,1655,1-2,3392,82,1.0495468277945619
4419,2021,3,31,Germany,North Macedonia,1,2,World Cup qualifier,,1934,1600,Germany-North Macedonia,1-2,1934,1600,1-2,3534,334,1.20875
4420,2021,3,31,England,Poland,2,1,World Cup qualifier,,1978,1808,England-Poland,2-1,1978,1808,2-1,3786,170,1.0940265486725664
4421,2021,3,31,Bosnia and Herzegovina,France,0,1,World Cup qualifier,,1635,2082,Bosnia and Herzegovina-France,0-1,2082,1635,1-0,3717,447,1.273394495412844
4422,2021,3,31,Austria,Denmark,0,3,World Cup qualifier,,1755,1972,Austria-Denmark,0-3,1972,1755,3-0,3727,217,1.1236467236467236
4485,2021,6,3,Costa Rica,Mexico,0,0,CONCACAF Nations League,US,1637,1913,Costa Rica-Mexico,0-0,1913,1637,0-0,3550,276,1.1686010995723886
4486,2021,6,3,Uruguay,Paraguay,0,0,World Cup qualifier,,1940,1782,Uruguay-Paraguay,0-0,1940,1782,0-0,3722,158,1.0886644219977553
4487,2021,6,3,Peru,Colombia,0,3,World Cup qualifier,,1758,1931,Peru-Colombia,0-3,1931,1758,3-0,3689,173,1.0984072810011376
4488,2021,6,3,Bolivia,Venezuela,3,1,World Cup qualifier,,1618,1761,Bolivia-Venezuela,3-1,1761,1618,1-3,3379,143,1.088380716934487
4489,2021,6,3,Argentina,Chile,1,1,World Cup qualifier,,1978,1829,Argentina-Chile,1-1,1978,1829,1-1,3807,149,1.0814652815746308
4508,2021,6,4,Brazil,Ecuador,2,0,World Cup qualifier,,2141,1823,Brazil-Ecuador,2-0,2141,1823,2-0,3964,318,1.1744377399890291
4538,2021,6,6,United States,Mexico,3,2,CONCACAF Nations League,,1792,1890,United States-Mexico,3-2,1890,1792,2-3,3682,98,1.0546875
4581,2021,6,8,Venezuela,Uruguay,0,0,World Cup qualifier,,1765,1936,Venezuela-Uruguay,0-0,1936,1765,0-0,3701,171,1.0968838526912181
4582,2021,6,8,Paraguay,Brazil,0,2,World Cup qualifier,,1771,2152,Paraguay-Brazil,0-2,2152,1771,2-0,3923,381,1.215132693393563
4583,2021,6,8,Ecuador,Peru,1,2,World Cup qualifier,,1794,1787,Ecuador-Peru,1-2,1794,1787,1-2,3581,7,1.0039171796306658
4584,2021,6,8,Colombia,Argentina,2,2,World Cup qualifier,,1928,1981,Colombia-Argentina,2-2,1981,1928,2-2,3909,53,1.0274896265560165
4585,2021,6,8,Chile,Bolivia,1,1,World Cup qualifier,,1815,1632,Chile-Bolivia,1-1,1815,1632,1-1,3447,183,1.1121323529411764
4612,2021,6,11,Italy,Turkey,3,0,European Championship,,2026,1789,Italy-Turkey,3-0,2026,1789,3-0,3815,237,1.1324762437115707
4616,2021,6,12,Switzerland,Wales,1,1,European Championship,AZ,1886,1837,Switzerland-Wales,1-1,1886,1837,1-1,3723,49,1.0266739248775176
4617,2021,6,12,Russia,Belgium,0,3,European Championship,,1728,2116,Russia-Belgium,0-3,2116,1728,3-0,3844,388,1.224537037037037
4618,2021,6,12,Denmark,Finland,0,1,European Championship,,1928,1729,Denmark-Finland,0-1,1928,1729,0-1,3657,199,1.1150954308849046
4625,2021,6,13,Netherlands,Ukraine,3,2,European Championship,,1959,1804,Netherlands-Ukraine,3-2,1959,1804,3-2,3763,155,1.085920177383592
4626,2021,6,13,England,Croatia,1,0,European Championship,,1991,1816,England-Croatia,1-0,1991,1816,1-0,3807,175,1.09636563876652
4628,2021,6,13,Colombia,Ecuador,1,0,Copa AmÃ©rica,BR,1944,1778,Colombia-Ecuador,1-0,1944,1778,1-0,3722,166,1.0933633295838021
4629,2021,6,13,Brazil,Venezuela,3,0,Copa AmÃ©rica,,2157,1760,Brazil-Venezuela,3-0,2157,1760,3-0,3917,397,1.2255681818181818
4631,2021,6,14,Spain,Sweden,0,0,European Championship,,2016,1867,Spain-Sweden,0-0,2016,1867,0-0,3883,149,1.0798071772897697
4632,2021,6,14,Slovakia,Poland,2,1,European Championship,RU,1691,1761,Slovakia-Poland,2-1,1761,1691,1-2,3452,70,1.0413956238911886
4633,2021,6,14,Scotland,Czechia,0,2,European Championship,,1639,1807,Scotland-Czechia,0-2,1807,1639,2-0,3446,168,1.1025015253203172
4634,2021,6,14,Paraguay,Bolivia,3,1,Copa AmÃ©rica,BR,1794,1609,Paraguay-Bolivia,3-1,1794,1609,3-1,3403,185,1.1149782473586078
4635,2021,6,14,Argentina,Chile,1,1,Copa AmÃ©rica,BR,1970,1826,Argentina-Chile,1-1,1970,1826,1-1,3796,144,1.0788608981380066
4645,2021,6,15,Iran,Iraq,1,0,World Cup and Asian Cup qualifier,BH,1804,1621,Iran-Iraq,1-0,1804,1621,1-0,3425,183,1.1128932757557064
4653,2021,6,15,Hungary,Portugal,0,3,European Championship,,1720,2061,Hungary-Portugal,0-3,2061,1720,3-0,3781,341,1.1982558139534885
4654,2021,6,15,Germany,France,0,1,European Championship,,1915,2108,Germany-France,0-1,2108,1915,1-0,4023,193,1.1007832898172323
4658,2021,6,16,Wales,Turkey,2,0,European Championship,AZ,1869,1757,Wales-Turkey,2-0,1869,1757,2-0,3626,112,1.0637450199203187
4659,2021,6,16,Russia,Finland,1,0,European Championship,,1746,1711,Russia-Finland,1-0,1746,1711,1-0,3457,35,1.0204558737580363
4660,2021,6,16,Italy,Switzerland,3,0,European Championship,,2044,1868,Italy-Switzerland,3-0,2044,1868,3-0,3912,176,1.094218415417559
4663,2021,6,17,Netherlands,Austria,2,0,European Championship,,1971,1758,Netherlands-Austria,2-0,1971,1758,2-0,3729,213,1.121160409556314
4664,2021,6,17,Denmark,Belgium,1,2,European Championship,,1909,2135,Denmark-Belgium,1-2,2135,1909,2-1,4044,226,1.1183865898376113
4665,2021,6,17,Colombia,Venezuela,0,0,Copa AmÃ©rica,BR,1932,1772,Colombia-Venezuela,0-0,1932,1772,0-0,3704,160,1.090293453724605
4666,2021,6,17,Brazil,Peru,4,0,Copa AmÃ©rica,,2163,1781,Brazil-Peru,4-0,2163,1781,4-0,3944,382,1.214486243683324
4667,2021,6,18,Sweden,Slovakia,1,0,European Championship,RU,1880,1678,Sweden-Slovakia,1-0,1880,1678,1-0,3558,202,1.1203814064362336
4668,2021,6,18,England,Scotland,0,0,European Championship,,1969,1661,England-Scotland,0-0,1969,1661,0-0,3630,308,1.185430463576159
4669,2021,6,18,Croatia,Czechia,1,1,European Championship,SQ,1815,1808,Croatia-Czechia,1-1,1815,1808,1-1,3623,7,1.0038716814159292
4671,2021,6,18,Argentina,Uruguay,1,0,Copa AmÃ©rica,BR,1993,1913,Argentina-Uruguay,1-0,1993,1913,1-0,3906,80,1.0418191322530057
4673,2021,6,19,Spain,Poland,1,1,European Championship,,1997,1780,Spain-Poland,1-1,1997,1780,1-1,3777,217,1.1219101123595505
4674,2021,6,19,Hungary,France,1,1,European Championship,,1737,2091,Hungary-France,1-1,2091,1737,1-1,3828,354,1.2037996545768566
4675,2021,6,19,Germany,Portugal,4,2,European Championship,,1957,2019,Germany-Portugal,4-2,2019,1957,2-4,3976,62,1.0316811446090957
4677,2021,6,20,Switzerland,Turkey,3,1,European Championship,AZ,1894,1731,Switzerland-Turkey,3-1,1894,1731,3-1,3625,163,1.094165222414789
4678,2021,6,20,Italy,Wales,1,0,European Championship,,2053,1860,Italy-Wales,1-0,2053,1860,1-0,3913,193,1.103763440860215
4679,2021,6,20,Peru,Colombia,2,1,Copa AmÃ©rica,BR,1816,1897,Peru-Colombia,2-1,1897,1816,1-2,3713,81,1.044603524229075
4680,2021,6,20,Ecuador,Venezuela,2,2,Copa AmÃ©rica,BR,1778,1772,Ecuador-Venezuela,2-2,1778,1772,2-2,3550,6,1.0033860045146727
4682,2021,6,21,Denmark,Russia,4,1,European Championship,,1925,1730,Denmark-Russia,4-1,1925,1730,4-1,3655,195,1.1127167630057804
4683,2021,6,21,Belgium,Finland,2,0,European Championship,RU,2141,1705,Belgium-Finland,2-0,2141,1705,2-0,3846,436,1.2557184750733137
4684,2021,6,21,Austria,Ukraine,1,0,European Championship,RO,1787,1786,Austria-Ukraine,1-0,1787,1786,1-0,3573,1,1.0005599104143337
4685,2021,6,21,Chile,Uruguay,1,1,Copa AmÃ©rica,BR,1842,1908,Chile-Uruguay,1-1,1908,1842,1-1,3750,66,1.0358306188925082
4686,2021,6,21,Argentina,Paraguay,1,0,Copa AmÃ©rica,BR,2005,1782,Argentina-Paraguay,1-0,2005,1782,1-0,3787,223,1.1251402918069584
4688,2021,6,22,Scotland,Croatia,1,3,European Championship,,1629,1847,Scotland-Croatia,1-3,1847,1629,3-1,3476,218,1.1338244321669737
4689,2021,6,22,England,Czechia,1,0,European Championship,,1978,1799,England-Czechia,1-0,1978,1799,1-0,3777,179,1.0994997220678155
4691,2021,6,23,Sweden,Poland,3,2,European Championship,RU,1898,1762,Sweden-Poland,3-2,1898,1762,3-2,3660,136,1.0771850170261068
4692,2021,6,23,Spain,Slovakia,4,0,European Championship,,2005,1670,Spain-Slovakia,4-0,2005,1670,4-0,3675,335,1.2005988023952097
4693,2021,6,23,Germany,Hungary,2,2,European Championship,,1939,1755,Germany-Hungary,2-2,1939,1755,2-2,3694,184,1.1048433048433048
4694,2021,6,23,France,Portugal,2,2,European Championship,HU,2086,2024,France-Portugal,2-2,2086,2024,2-2,4110,62,1.0306324110671936
4696,2021,6,23,Ecuador,Peru,2,2,Copa AmÃ©rica,BR,1781,1813,Ecuador-Peru,2-2,1813,1781,2-2,3594,32,1.0179674340258282
4697,2021,6,23,Brazil,Colombia,2,1,Copa AmÃ©rica,,2168,1892,Brazil-Colombia,2-1,2168,1892,2-1,4060,276,1.145877378435518
4700,2021,6,24,Paraguay,Chile,2,0,Copa AmÃ©rica,BR,1826,1798,Paraguay-Chile,2-0,1826,1798,2-0,3624,28,1.0155728587319244
4702,2021,6,26,Italy,Austria,2,1,European Championship,EN,2062,1778,Italy-Austria,2-1,2062,1778,2-1,3840,284,1.1597300337457819
4703,2021,6,26,Denmark,Wales,4,0,European Championship,NL,1963,1822,Denmark-Wales,4-0,1963,1822,4-0,3785,141,1.0773874862788144
4705,2021,6,27,Czechia,Netherlands,2,0,European Championship,HU,1854,1921,Czechia-Netherlands,2-0,1921,1854,0-2,3775,67,1.0361380798274002
4706,2021,6,27,Belgium,Portugal,1,0,European Championship,ES,2158,2007,Belgium-Portugal,1-0,2158,2007,1-0,4165,151,1.0752366716492276
4707,2021,6,27,Peru,Venezuela,1,0,Copa AmÃ©rica,BR,1835,1750,Peru-Venezuela,1-0,1835,1750,1-0,3585,85,1.0485714285714285
4708,2021,6,27,Brazil,Ecuador,1,1,Copa AmÃ©rica,,2146,1803,Brazil-Ecuador,1-1,2146,1803,1-1,3949,343,1.190238491403217
4709,2021,6,28,Spain,Croatia,4,3,European Championship,DK,2027,1825,Spain-Croatia,4-3,2027,1825,4-3,3852,202,1.1106849315068492
4710,2021,6,28,France,Switzerland,3,3,European Championship,RO,2073,1907,France-Switzerland,3-3,2073,1907,3-3,3980,166,1.087047718930257
4712,2021,6,28,Uruguay,Paraguay,1,0,Copa AmÃ©rica,BR,1937,1808,Uruguay-Paraguay,1-0,1937,1808,1-0,3745,129,1.071349557522124
4714,2021,6,29,Ukraine,Sweden,2,1,European Championship,SQ,1819,1865,Ukraine-Sweden,2-1,1865,1819,1-2,3684,46,1.0252886201209457
4715,2021,6,29,England,Germany,2,0,European Championship,,2001,1916,England-Germany,2-0,2001,1916,2-0,3917,85,1.0443632567849688
4717,2021,7,2,Spain,Switzerland,1,1,European Championship,RU,2019,1915,Spain-Switzerland,1-1,2019,1915,1-1,3934,104,1.054308093994778
4718,2021,7,2,Italy,Belgium,2,1,European Championship,DE,2094,2126,Italy-Belgium,2-1,2126,2094,1-2,4220,32,1.0152817574021011
4722,2021,7,2,Paraguay,Peru,3,3,Copa AmÃ©rica,BR,1810,1833,Paraguay-Peru,3-3,1833,1810,3-3,3643,23,1.0127071823204419
4723,2021,7,2,Brazil,Chile,1,0,Copa AmÃ©rica,,2150,1794,Brazil-Chile,1-0,2150,1794,1-0,3944,356,1.1984392419175027
4726,2021,7,3,England,Ukraine,4,0,European Championship,IT,2025,1795,England-Ukraine,4-0,2025,1795,4-0,3820,230,1.128133704735376
4727,2021,7,3,Denmark,Czechia,2,1,European Championship,AZ,1980,1837,Denmark-Czechia,2-1,1980,1837,2-1,3817,143,1.0778443113772456
4730,2021,7,3,Colombia,Uruguay,0,0,Copa AmÃ©rica,BR,1895,1934,Colombia-Uruguay,0-0,1934,1895,0-0,3829,39,1.020580474934037
4731,2021,7,3,Argentina,Ecuador,3,0,Copa AmÃ©rica,BR,2032,1783,Argentina-Ecuador,3-0,2032,1783,3-0,3815,249,1.139652271452608
4734,2021,7,5,Brazil,Peru,1,0,Copa AmÃ©rica,,2154,1829,Brazil-Peru,1-0,2154,1829,1-0,3983,325,1.1776927282668124
4737,2021,7,6,Italy,Spain,1,1,European Championship,EN,2089,2024,Italy-Spain,1-1,2089,2024,1-1,4113,65,1.032114624505929
4741,2021,7,6,Argentina,Colombia,1,1,Copa AmÃ©rica,BR,2023,1904,Argentina-Colombia,1-1,2023,1904,1-1,3927,119,1.0625
4744,2021,7,7,England,Denmark,2,1,European Championship,,2040,1965,England-Denmark,2-1,2040,1965,2-1,4005,75,1.0381679389312977
4749,2021,7,9,Colombia,Peru,3,2,Copa AmÃ©rica,BR,1924,1809,Colombia-Peru,3-2,1924,1809,3-2,3733,115,1.0635710337202875
4753,2021,7,10,Brazil,Argentina,0,1,Copa AmÃ©rica,,2114,2063,Brazil-Argentina,0-1,2114,2063,0-1,4177,51,1.0247212796897722
4756,2021,7,11,England,Italy,1,1,European Championship,,2036,2093,England-Italy,1-1,2093,2036,1-1,4129,57,1.0279960707269156
4784,2021,7,18,United States,Canada,1,0,CONCACAF Championship,,1823,1705,United States-Canada,1-0,1823,1705,1-0,3528,118,1.069208211143695
4795,2021,7,25,Canada,Costa Rica,2,0,CONCACAF Championship,US,1738,1631,Canada-Costa Rica,2-0,1738,1631,2-0,3369,107,1.0656039239730226
4796,2021,7,29,United States,Qatar,1,0,CONCACAF Championship,,1840,1697,United States-Qatar,1-0,1840,1697,1-0,3537,143,1.0842663523865645
4797,2021,7,29,Mexico,Canada,2,1,CONCACAF Championship,US,1916,1724,Mexico-Canada,2-1,1916,1724,2-1,3640,192,1.111368909512761
4798,2021,8,1,United States,Mexico,1,0,CONCACAF Championship,,1863,1893,United States-Mexico,1-0,1893,1863,0-1,3756,30,1.0161030595813205
4819,2021,9,1,Slovenia,Slovakia,1,1,World Cup qualifier,,1614,1673,Slovenia-Slovakia,1-1,1673,1614,1-1,3287,59,1.0365551425030979
4820,2021,9,1,Russia,Croatia,0,0,World Cup qualifier,,1730,1825,Russia-Croatia,0-0,1825,1730,0-0,3555,95,1.0549132947976878
4821,2021,9,1,Portugal,Ireland,2,1,World Cup qualifier,,2009,1620,Portugal-Ireland,2-1,2009,1620,2-1,3629,389,1.2401234567901234
4822,2021,9,1,Norway,Netherlands,1,1,World Cup qualifier,,1743,1916,Norway-Netherlands,1-1,1916,1743,1-1,3659,173,1.0992541594951233
4828,2021,9,1,France,Bosnia and Herzegovina,1,1,World Cup qualifier,,2055,1646,France-Bosnia and Herzegovina,1-1,2055,1646,1-1,3701,409,1.2484811664641555
4830,2021,9,1,Denmark,Scotland,2,0,World Cup qualifier,,1970,1624,Denmark-Scotland,2-0,1970,1624,2-0,3594,346,1.2130541871921183
4834,2021,9,2,South Korea,Iraq,0,0,World Cup qualifier,,1751,1633,South Korea-Iraq,0-0,1751,1633,0-0,3384,118,1.0722596448254746
4846,2021,9,2,Sweden,Spain,2,1,World Cup qualifier,,1888,2001,Sweden-Spain,2-1,2001,1888,1-2,3889,113,1.0598516949152543
4852,2021,9,2,Hungary,England,0,3,World Cup qualifier,,1735,2056,Hungary-England,0-3,2056,1735,3-0,3791,321,1.185014409221902
4862,2021,9,2,Venezuela,Argentina,1,3,World Cup qualifier,,1736,2077,Venezuela-Argentina,1-3,2077,1736,3-1,3813,341,1.1964285714285714
4863,2021,9,2,Peru,Uruguay,1,1,World Cup qualifier,,1810,1933,Peru-Uruguay,1-1,1933,1810,1-1,3743,123,1.0679558011049723
4864,2021,9,2,Ecuador,Paraguay,2,0,World Cup qualifier,,1807,1786,Ecuador-Paraguay,2-0,1807,1786,2-0,3593,21,1.0117581187010078
4865,2021,9,2,Chile,Brazil,0,1,World Cup qualifier,,1785,2123,Chile-Brazil,0-1,2123,1785,1-0,3908,338,1.1893557422969188
4878,2021,9,4,Ukraine,France,1,1,World Cup qualifier,,1789,2046,Ukraine-France,1-1,2046,1789,1-1,3835,257,1.1436556735606485
4880,2021,9,4,Slovakia,Croatia,0,1,World Cup qualifier,,1656,1842,Slovakia-Croatia,0-1,1842,1656,1-0,3498,186,1.1123188405797102
4885,2021,9,4,Israel,Austria,4,2,World Cup qualifier,,1663,1741,Israel-Austria,4-2,1741,1663,2-4,3404,78,1.0469031870114252
4899,2021,9,5,Switzerland,Italy,0,0,World Cup qualifier,,1920,2071,Switzerland-Italy,0-0,2071,1920,0-0,3991,151,1.0786458333333333
4908,2021,9,5,Belgium,Czechia,3,0,World Cup qualifier,,2135,1833,Belgium-Czechia,3-0,2135,1833,3-0,3968,302,1.1647572285870158
4910,2021,9,5,United States,Canada,1,1,World Cup qualifier,,1840,1724,United States-Canada,1-1,1840,1724,1-1,3564,116,1.0672853828306264
4913,2021,9,5,Costa Rica,Mexico,0,1,World Cup qualifier,,1618,1907,Costa Rica-Mexico,0-1,1907,1618,1-0,3525,289,1.1786155747836835
4915,2021,9,5,Peru,Venezuela,1,0,World Cup qualifier,,1821,1725,Peru-Venezuela,1-0,1821,1725,1-0,3546,96,1.0556521739130436
4916,2021,9,5,Paraguay,Colombia,1,1,World Cup qualifier,,1787,1911,Paraguay-Colombia,1-1,1911,1787,1-1,3698,124,1.0693900391717963
4917,2021,9,5,Ecuador,Chile,0,0,World Cup qualifier,,1800,1792,Ecuador-Chile,0-0,1800,1792,0-0,3592,8,1.0044642857142858
4933,2021,9,7,Iran,Iraq,3,0,World Cup qualifier,QA,1826,1614,Iran-Iraq,3-0,1826,1614,3-0,3440,212,1.131350681536555
4948,2021,9,7,Netherlands,Turkey,4,1,World Cup qualifier,,1932,1708,Netherlands-Turkey,4-1,1932,1708,4-1,3640,224,1.1311475409836065
4950,2021,9,7,Ireland,Serbia,1,1,World Cup qualifier,,1610,1798,Ireland-Serbia,1-1,1798,1610,1-1,3408,188,1.1167701863354038
4951,2021,9,7,France,Finland,2,0,World Cup qualifier,,2050,1704,France-Finland,2-0,2050,1704,2-0,3754,346,1.2030516431924883
4953,2021,9,7,Denmark,Israel,4,0,World Cup qualifier,,1978,1656,Denmark-Israel,4-0,1978,1656,4-0,3634,322,1.1944444444444444
4954,2021,9,7,Croatia,Slovenia,3,0,World Cup qualifier,,1851,1608,Croatia-Slovenia,3-0,1851,1608,3-0,3459,243,1.1511194029850746
4956,2021,9,7,Austria,Scotland,0,1,World Cup qualifier,,1710,1657,Austria-Scotland,0-1,1710,1657,0-1,3367,53,1.031985515992758
4961,2021,9,8,Poland,England,1,1,World Cup qualifier,,1783,2046,Poland-England,1-1,2046,1783,1-1,3829,263,1.1475042063937184
4962,2021,9,8,Northern Ireland,Switzerland,0,0,World Cup qualifier,,1607,1909,Northern Ireland-Switzerland,0-0,1909,1607,0-0,3516,302,1.1879278158058495
4968,2021,9,8,Greece,Sweden,2,1,World Cup qualifier,,1683,1862,Greece-Sweden,2-1,1862,1683,1-2,3545,179,1.1063576945929887
4972,2021,9,8,Panama,Mexico,1,1,World Cup qualifier,,1601,1896,Panama-Mexico,1-1,1896,1601,1-1,3497,295,1.184259837601499
4976,2021,9,9,Uruguay,Ecuador,1,0,World Cup qualifier,,1945,1792,Uruguay-Ecuador,1-0,1945,1792,1-0,3737,153,1.0853794642857142
4977,2021,9,9,Paraguay,Venezuela,2,1,World Cup qualifier,,1798,1714,Paraguay-Venezuela,2-1,1798,1714,2-1,3512,84,1.0490081680280046
4978,2021,9,9,Colombia,Chile,3,1,World Cup qualifier,,1924,1779,Colombia-Chile,3-1,1924,1779,3-1,3703,145,1.0815064643057897
4979,2021,9,9,Brazil,Peru,2,0,World Cup qualifier,,2128,1816,Brazil-Peru,2-0,2128,1816,2-0,3944,312,1.171806167400881
4995,2021,10,6,Italy,Spain,1,2,European Nations League,,2036,2045,Italy-Spain,1-2,2045,2036,2-1,4081,9,1.0044204322200392
5001,2021,10,7,Saudi Arabia,Japan,1,0,World Cup qualifier,,1657,1723,Saudi Arabia-Japan,1-0,1723,1657,0-1,3380,66,1.0398310199155099
5013,2021,10,7,France,Belgium,3,2,European Nations League,IT,2081,2105,France-Belgium,3-2,2105,2081,2-3,4186,24,1.011532916866891
5015,2021,10,7,Mexico,Canada,1,1,World Cup qualifier,,1883,1749,Mexico-Canada,1-1,1883,1749,1-1,3632,134,1.0766152086906804
5018,2021,10,7,Venezuela,Brazil,1,3,World Cup qualifier,,1706,2136,Venezuela-Brazil,1-3,2136,1706,3-1,3842,430,1.2520515826494725
5019,2021,10,7,Uruguay,Colombia,0,0,World Cup qualifier,,1938,1931,Uruguay-Colombia,0-0,1938,1931,0-0,3869,7,1.0036250647332987
5020,2021,10,7,Peru,Chile,2,0,World Cup qualifier,,1835,1760,Peru-Chile,2-0,1835,1760,2-0,3595,75,1.0426136363636365
5021,2021,10,7,Paraguay,Argentina,0,0,World Cup qualifier,,1808,2069,Paraguay-Argentina,0-0,2069,1808,0-0,3877,261,1.144358407079646
5029,2021,10,8,Turkey,Norway,1,1,World Cup qualifier,,1705,1754,Turkey-Norway,1-1,1754,1705,1-1,3459,49,1.0287390029325514
5030,2021,10,8,Russia,Slovakia,1,0,World Cup qualifier,,1751,1650,Russia-Slovakia,1-0,1751,1650,1-0,3401,101,1.0612121212121213
5036,2021,10,8,Germany,Romania,2,1,World Cup qualifier,,1942,1663,Germany-Romania,2-1,1942,1663,2-1,3605,279,1.1677690920024053
5038,2021,10,8,Czechia,Wales,2,2,World Cup qualifier,,1822,1816,Czechia-Wales,2-2,1822,1816,2-2,3638,6,1.0033039647577093
5051,2021,10,9,Switzerland,Northern Ireland,2,0,World Cup qualifier,,1914,1602,Switzerland-Northern Ireland,2-0,1914,1602,2-0,3516,312,1.1947565543071161
5053,2021,10,9,Scotland,Israel,3,2,World Cup qualifier,,1671,1642,Scotland-Israel,3-2,1671,1642,3-2,3313,29,1.017661388550548
5059,2021,10,9,Hungary,Albania,0,1,World Cup qualifier,,1678,1605,Hungary-Albania,0-1,1678,1605,0-1,3283,73,1.0454828660436137
5061,2021,10,9,Finland,Ukraine,1,2,World Cup qualifier,,1683,1814,Finland-Ukraine,1-2,1814,1683,2-1,3497,131,1.0778371954842543
5075,2021,10,10,Italy,Belgium,2,1,European Nations League,,2059,2082,Italy-Belgium,2-1,2082,2059,1-2,4141,23,1.011170471102477
5076,2021,10,10,France,Spain,2,1,European Nations League,IT,2103,2023,France-Spain,2-1,2103,2023,2-1,4126,80,1.0395452298566485
5077,2021,10,10,Panama,United States,1,0,World Cup qualifier,,1612,1837,Panama-United States,1-0,1837,1612,0-1,3449,225,1.1395781637717122
5081,2021,10,10,Venezuela,Ecuador,2,1,World Cup qualifier,,1726,1782,Venezuela-Ecuador,2-1,1782,1726,1-2,3508,56,1.0324449594438008
5082,2021,10,10,Colombia,Brazil,0,0,World Cup qualifier,,1937,2130,Colombia-Brazil,0-0,2130,1937,0-0,4067,193,1.09963861641714
5083,2021,10,10,Chile,Paraguay,2,0,World Cup qualifier,,1786,1782,Chile-Paraguay,2-0,1786,1782,2-0,3568,4,1.0022446689113356
5084,2021,10,10,Bolivia,Peru,1,0,World Cup qualifier,,1605,1806,Bolivia-Peru,1-0,1806,1605,0-1,3411,201,1.125233644859813
5085,2021,10,10,Argentina,Uruguay,3,0,World Cup qualifier,,2084,1923,Argentina-Uruguay,3-0,2084,1923,3-0,4007,161,1.0837233489339573
5092,2021,10,11,Slovenia,Russia,1,2,World Cup qualifier,,1604,1769,Slovenia-Russia,1-2,1769,1604,2-1,3373,165,1.10286783042394
5102,2021,10,11,Croatia,Slovakia,2,2,World Cup qualifier,,1842,1664,Croatia-Slovakia,2-2,1842,1664,2-2,3506,178,1.1069711538461537
5112,2021,10,12,Japan,Australia,2,1,World Cup qualifier,,1740,1755,Japan-Australia,2-1,1755,1740,1-2,3495,15,1.0086206896551724
5113,2021,10,12,Iran,South Korea,1,1,World Cup qualifier,,1825,1765,Iran-South Korea,1-1,1825,1765,1-1,3590,60,1.0339943342776203
5120,2021,10,12,Ukraine,Bosnia and Herzegovina,1,1,World Cup qualifier,,1801,1662,Ukraine-Bosnia and Herzegovina,1-1,1801,1662,1-1,3463,139,1.0836341756919374
5121,2021,10,12,Sweden,Greece,2,0,World Cup qualifier,,1878,1694,Sweden-Greece,2-0,1878,1694,2-0,3572,184,1.1086186540731995
5130,2021,10,12,England,Hungary,1,1,World Cup qualifier,,2029,1695,England-Hungary,1-1,2029,1695,1-1,3724,334,1.1970501474926254
5131,2021,10,12,Denmark,Austria,1,0,World Cup qualifier,,1983,1713,Denmark-Austria,1-0,1983,1713,1-0,3696,270,1.157618213660245
5136,2021,10,13,United States,Costa Rica,2,1,World Cup qualifier,,1843,1617,United States-Costa Rica,2-1,1843,1617,2-1,3460,226,1.139764996907854
5140,2021,10,14,Colombia,Ecuador,0,0,World Cup qualifier,,1924,1795,Colombia-Ecuador,0-0,1924,1795,0-0,3719,129,1.0718662952646238
5141,2021,10,14,Chile,Venezuela,3,0,World Cup qualifier,,1806,1706,Chile-Venezuela,3-0,1806,1706,3-0,3512,100,1.0586166471277842
5142,2021,10,14,Brazil,Uruguay,4,1,World Cup qualifier,,2140,1913,Brazil-Uruguay,4-1,2140,1913,4-1,4053,227,1.118661787767904
5143,2021,10,14,Bolivia,Paraguay,4,0,World Cup qualifier,,1651,1736,Bolivia-Paraguay,4-0,1736,1651,0-4,3387,85,1.0514839491217445
5144,2021,10,14,Argentina,Peru,1,0,World Cup qualifier,,2088,1802,Argentina-Peru,1-0,2088,1802,1-0,3890,286,1.1587125416204218
5161,2021,11,11,Australia,Saudi Arabia,0,0,World Cup qualifier,,1745,1674,Australia-Saudi Arabia,0-0,1745,1674,0-0,3419,71,1.0424133811230585
5170,2021,11,11,Slovakia,Slovenia,2,2,World Cup qualifier,,1655,1613,Slovakia-Slovenia,2-2,1655,1613,2-2,3268,42,1.0260384376937384
5174,2021,11,11,Ireland,Portugal,0,0,World Cup qualifier,,1660,2007,Ireland-Portugal,0-0,2007,1660,0-0,3667,347,1.2090361445783133
5175,2021,11,11,Greece,Spain,0,1,World Cup qualifier,,1686,2031,Greece-Spain,0-1,2031,1686,1-0,3717,345,1.204626334519573
5180,2021,11,11,Peru,Bolivia,3,0,World Cup qualifier,,1816,1643,Peru-Bolivia,3-0,1816,1643,3-0,3459,173,1.105295191722459
5181,2021,11,11,Paraguay,Chile,0,1,World Cup qualifier,,1714,1828,Paraguay-Chile,0-1,1828,1714,1-0,3542,114,1.0665110851808635
5182,2021,11,11,Ecuador,Venezuela,1,0,World Cup qualifier,,1818,1696,Ecuador-Venezuela,1-0,1818,1696,1-0,3514,122,1.071933962264151
5183,2021,11,11,Brazil,Colombia,1,0,World Cup qualifier,,2146,1918,Brazil-Colombia,1-0,2146,1918,1-0,4064,228,1.118873826903024
5192,2021,11,12,Italy,Switzerland,1,1,World Cup qualifier,,2047,1930,Italy-Switzerland,1-1,2047,1930,1-1,3977,117,1.0606217616580311
5196,2021,11,12,Austria,Israel,4,2,World Cup qualifier,,1729,1628,Austria-Israel,4-2,1729,1628,4-2,3357,101,1.0620393120393121
5198,2021,11,12,United States,Mexico,2,0,World Cup qualifier,,1868,1862,United States-Mexico,2-0,1868,1862,2-0,3730,6,1.0032223415682062
5201,2021,11,12,Canada,Costa Rica,1,0,World Cup qualifier,,1765,1609,Canada-Costa Rica,1-0,1765,1609,1-0,3374,156,1.0969546302050963
5202,2021,11,12,Uruguay,Argentina,0,1,World Cup qualifier,,1897,2104,Uruguay-Argentina,0-1,2104,1897,1-0,4001,207,1.1091196626251978
5219,2021,11,13,Bosnia and Herzegovina,Finland,1,3,World Cup qualifier,,1626,1732,Bosnia and Herzegovina-Finland,1-3,1732,1626,3-1,3358,106,1.065190651906519
5228,2021,11,14,Spain,Sweden,1,0,World Cup qualifier,,2037,1822,Spain-Sweden,1-0,2037,1822,1-0,3859,215,1.1180021953896817
5230,2021,11,14,Portugal,Serbia,1,2,World Cup qualifier,,1973,1847,Portugal-Serbia,1-2,1973,1847,1-2,3820,126,1.0682187330806714
5236,2021,11,14,Croatia,Russia,1,0,World Cup qualifier,,1858,1761,Croatia-Russia,1-0,1858,1761,1-0,3619,97,1.0550823395797841
5245,2021,11,15,Scotland,Denmark,2,0,World Cup qualifier,,1729,1937,Scotland-Denmark,2-0,1937,1729,0-2,3666,208,1.1203007518796992
5247,2021,11,15,Poland,Hungary,1,2,World Cup qualifier,,1770,1726,Poland-Hungary,1-2,1770,1726,1-2,3496,44,1.0254924681344149
5248,2021,11,15,Northern Ireland,Italy,0,0,World Cup qualifier,,1602,2031,Northern Ireland-Italy,0-0,2031,1602,0-0,3633,429,1.2677902621722847
5273,2021,11,16,Cameroon,Ivory Coast,1,0,World Cup qualifier,,1609,1648,Cameroon-Ivory Coast,1-0,1648,1609,0-1,3257,39,1.024238657551274
5275,2021,11,16,Wales,Belgium,1,1,World Cup qualifier,,1836,2075,Wales-Belgium,1-1,2075,1836,1-1,3911,239,1.1301742919389979
5276,2021,11,16,Netherlands,Norway,2,0,World Cup qualifier,,1929,1733,Netherlands-Norway,2-0,1929,1733,2-0,3662,196,1.1130986728216965
5279,2021,11,16,Finland,France,0,2,World Cup qualifier,,1722,2114,Finland-France,0-2,2114,1722,2-0,3836,392,1.2276422764227641
5281,2021,11,16,Bosnia and Herzegovina,Ukraine,0,2,World Cup qualifier,,1602,1817,Bosnia and Herzegovina-Ukraine,0-2,1817,1602,2-0,3419,215,1.134207240948814
5285,2021,11,16,Canada,Mexico,2,1,World Cup qualifier,,1785,1842,Canada-Mexico,2-1,1842,1785,1-2,3627,57,1.0319327731092438
5286,2021,11,16,Venezuela,Peru,1,2,World Cup qualifier,,1677,1835,Venezuela-Peru,1-2,1835,1677,2-1,3512,158,1.0942158616577222
5287,2021,11,16,Colombia,Paraguay,0,0,World Cup qualifier,,1904,1728,Colombia-Paraguay,0-0,1904,1728,0-0,3632,176,1.1018518518518519
5288,2021,11,16,Chile,Ecuador,0,2,World Cup qualifier,,1789,1857,Chile-Ecuador,0-2,1857,1789,2-0,3646,68,1.0380100614868641
5289,2021,11,16,Bolivia,Uruguay,3,0,World Cup qualifier,,1693,1847,Bolivia-Uruguay,3-0,1847,1693,0-3,3540,154,1.090962787950384
5290,2021,11,16,Argentina,Brazil,0,0,World Cup qualifier,,2101,2149,Argentina-Brazil,0-0,2149,2101,0-0,4250,48,1.02284626368396
5318,2021,12,7,Morocco,Saudi Arabia,1,0,Arab Cup,QA,1766,1628,Morocco-Saudi Arabia,1-0,1766,1628,1-0,3394,138,1.0847665847665848
5321,2021,12,7,Algeria,Egypt,1,1,Arab Cup,QA,1759,1656,Algeria-Egypt,1-1,1759,1656,1-1,3415,103,1.0621980676328502
5333,2021,12,11,Algeria,Morocco,2,2,Arab Cup,QA,1759,1766,Algeria-Morocco,2-2,1766,1759,2-2,3525,7,1.0039795338260376
5341,2021,12,15,Tunisia,Egypt,1,0,Arab Cup,QA,1660,1655,Tunisia-Egypt,1-0,1660,1655,1-0,3315,5,1.0030211480362539
5342,2021,12,15,Qatar,Algeria,1,2,Arab Cup,,1669,1781,Qatar-Algeria,1-2,1781,1669,2-1,3450,112,1.067106051527861
5345,2021,12,18,Qatar,Egypt,0,0,Arab Cup,,1663,1661,Qatar-Egypt,0-0,1663,1661,0-0,3324,2,1.0012040939193256
5346,2021,12,18,Algeria,Tunisia,2,0,Arab Cup,QA,1801,1640,Algeria-Tunisia,2-0,1801,1640,2-0,3441,161,1.098170731707317
5371,2022,1,11,Nigeria,Egypt,1,0,African Nations Cup,CM,1673,1635,Nigeria-Egypt,1-0,1673,1635,1-0,3308,38,1.0232415902140672
5375,2022,1,12,Mali,Tunisia,1,0,African Nations Cup,CM,1646,1613,Mali-Tunisia,1-0,1646,1613,1-0,3259,33,1.0204587724736516
5403,2022,1,20,Ivory Coast,Algeria,3,1,African Nations Cup,CM,1690,1695,Ivory Coast-Algeria,3-1,1695,1690,1-3,3385,5,1.0029585798816567
5410,2022,1,23,Tunisia,Nigeria,1,0,African Nations Cup,CM,1620,1661,Tunisia-Nigeria,1-0,1661,1620,0-1,3281,41,1.0253086419753086
5417,2022,1,26,Egypt,Ivory Coast,0,0,African Nations Cup,CM,1654,1687,Egypt-Ivory Coast,0-0,1687,1654,0-0,3341,33,1.0199516324062878
5431,2022,1,27,Costa Rica,Panama,1,0,World Cup qualifier,,1633,1620,Costa Rica-Panama,1-0,1633,1620,1-0,3253,13,1.0080246913580246
5432,2022,1,27,Paraguay,Uruguay,0,1,World Cup qualifier,,1709,1866,Paraguay-Uruguay,0-1,1866,1709,1-0,3575,157,1.0918665886483323
5433,2022,1,27,Ecuador,Brazil,1,1,World Cup qualifier,,1859,2139,Ecuador-Brazil,1-1,2139,1859,1-1,3998,280,1.1506186121570736
5434,2022,1,27,Chile,Argentina,1,2,World Cup qualifier,,1785,2110,Chile-Argentina,1-2,2110,1785,2-1,3895,325,1.1820728291316527
5437,2022,1,28,Venezuela,Bolivia,4,1,World Cup qualifier,,1704,1669,Venezuela-Bolivia,4-1,1704,1669,4-1,3373,35,1.0209706411024566
5438,2022,1,28,Colombia,Peru,0,1,World Cup qualifier,,1877,1861,Colombia-Peru,0-1,1877,1861,0-1,3738,16,1.0085975282106394
5447,2022,1,30,Egypt,Morocco,2,1,African Nations Cup,CM,1687,1735,Egypt-Morocco,2-1,1735,1687,1-2,3422,48,1.0284528749259039
5449,2022,1,30,Mexico,Costa Rica,0,0,World Cup qualifier,,1837,1648,Mexico-Costa Rica,0-0,1837,1648,0-0,3485,189,1.1146844660194175
5451,2022,1,30,Canada,United States,2,0,World Cup qualifier,,1827,1836,Canada-United States,2-0,1836,1827,0-2,3663,9,1.0049261083743843
5462,2022,2,1,Japan,Saudi Arabia,2,0,World Cup qualifier,,1780,1624,Japan-Saudi Arabia,2-0,1780,1624,2-0,3404,156,1.0960591133004927
5464,2022,2,1,Uruguay,Venezuela,4,1,World Cup qualifier,,1879,1691,Uruguay-Venezuela,4-1,1879,1691,4-1,3570,188,1.111176818450621
5465,2022,2,1,Peru,Ecuador,1,1,World Cup qualifier,,1855,1865,Peru-Ecuador,1-1,1865,1855,1-1,3720,10,1.005390835579515
5466,2022,2,1,Brazil,Paraguay,4,0,World Cup qualifier,,2142,1706,Brazil-Paraguay,4-0,2142,1706,4-0,3848,436,1.2555685814771396
5467,2022,2,1,Bolivia,Chile,2,3,World Cup qualifier,,1650,1804,Bolivia-Chile,2-3,1804,1650,3-2,3454,154,1.0933333333333333
5468,2022,2,1,Argentina,Colombia,1,0,World Cup qualifier,,2115,1872,Argentina-Colombia,1-0,2115,1872,1-0,3987,243,1.1298076923076923
5471,2022,2,2,Mexico,Panama,1,0,World Cup qualifier,,1843,1626,Mexico-Panama,1-0,1843,1626,1-0,3469,217,1.1334563345633457
5474,2022,2,3,Cameroon,Egypt,0,0,African Nations Cup,,1632,1690,Cameroon-Egypt,0-0,1690,1632,0-0,3322,58,1.0355392156862746
5476,2022,2,6,Egypt,Senegal,0,0,African Nations Cup,CM,1693,1731,Egypt-Senegal,0-0,1731,1693,0-0,3424,38,1.0224453632604844
5514,2022,3,24,South Korea,Iran,2,0,World Cup qualifier,,1832,1818,South Korea-Iran,2-0,1832,1818,2-0,3650,14,1.0077007700770078
5518,2022,3,24,Australia,Japan,0,2,World Cup qualifier,,1696,1814,Australia-Japan,0-2,1814,1696,2-0,3510,118,1.0695754716981132
5524,2022,3,24,Wales,Austria,2,1,World Cup qualifier,,1845,1722,Wales-Austria,2-1,1845,1722,2-1,3567,123,1.0714285714285714
5525,2022,3,24,Sweden,Czechia,1,0,World Cup qualifier,,1837,1819,Sweden-Czechia,1-0,1837,1819,1-0,3656,18,1.0098955470038482
5526,2022,3,24,Portugal,Turkey,3,1,World Cup qualifier,,1980,1720,Portugal-Turkey,3-1,1980,1720,3-1,3700,260,1.1511627906976745
5527,2022,3,24,Italy,North Macedonia,0,1,World Cup qualifier,,1993,1668,Italy-North Macedonia,0-1,1993,1668,0-1,3661,325,1.1948441247002397
5530,2022,3,24,Mexico,United States,0,0,World Cup qualifier,,1837,1846,Mexico-United States,0-0,1846,1837,0-0,3683,9,1.004899292324442
5531,2022,3,24,Costa Rica,Canada,1,0,World Cup qualifier,,1693,1818,Costa Rica-Canada,1-0,1818,1693,0-1,3511,125,1.073833431777909
5532,2022,3,24,Uruguay,Peru,1,0,World Cup qualifier,,1892,1842,Uruguay-Peru,1-0,1892,1842,1-0,3734,50,1.0271444082519001
5533,2022,3,24,Paraguay,Ecuador,3,1,World Cup qualifier,,1741,1830,Paraguay-Ecuador,3-1,1830,1741,1-3,3571,89,1.0511200459506032
5534,2022,3,24,Colombia,Bolivia,3,0,World Cup qualifier,,1881,1641,Colombia-Bolivia,3-0,1881,1641,3-0,3522,240,1.146252285191956
5535,2022,3,24,Brazil,Chile,4,0,World Cup qualifier,,2148,1798,Brazil-Chile,4-0,2148,1798,4-0,3946,350,1.1946607341490545
5552,2022,3,25,Mali,Tunisia,0,1,World Cup qualifier,,1602,1618,Mali-Tunisia,0-1,1618,1602,1-0,3220,16,1.0099875156054932
5554,2022,3,25,Egypt,Senegal,1,0,World Cup qualifier,,1709,1715,Egypt-Senegal,1-0,1715,1709,0-1,3424,6,1.0035108250438853
5556,2022,3,25,Cameroon,Algeria,0,1,World Cup qualifier,,1600,1716,Cameroon-Algeria,0-1,1716,1600,1-0,3316,116,1.0725
5557,2022,3,25,Argentina,Venezuela,3,0,World Cup qualifier,,2118,1688,Argentina-Venezuela,3-0,2118,1688,3-0,3806,430,1.254739336492891
5589,2022,3,27,United States,Panama,4,1,World Cup qualifier,,1856,1602,United States-Panama,4-1,1856,1602,4-1,3458,254,1.1585518102372034
5635,2022,3,29,Saudi Arabia,Australia,1,0,World Cup qualifier,,1634,1677,Saudi Arabia-Australia,1-0,1677,1634,0-1,3311,43,1.0263157894736843
5640,2022,3,29,Tunisia,Mali,0,0,World Cup qualifier,,1612,1608,Tunisia-Mali,0-0,1612,1608,0-0,3220,4,1.0024875621890548
5641,2022,3,29,Senegal,Egypt,1,0,World Cup qualifier,,1729,1695,Senegal-Egypt,1-0,1729,1695,1-0,3424,34,1.0200589970501475
5644,2022,3,29,Algeria,Cameroon,1,2,World Cup qualifier,,1685,1631,Algeria-Cameroon,1-2,1685,1631,1-2,3316,54,1.0331085223789087
5645,2022,3,29,Portugal,North Macedonia,2,0,World Cup qualifier,,1985,1663,Portugal-North Macedonia,2-0,1985,1663,2-0,3648,322,1.1936259771497295
5646,2022,3,29,Poland,Sweden,2,0,World Cup qualifier,,1799,1810,Poland-Sweden,2-0,1810,1799,0-2,3609,11,1.0061145080600333
5647,2022,3,29,Venezuela,Colombia,0,1,World Cup qualifier,,1673,1896,Venezuela-Colombia,0-1,1896,1673,1-0,3569,223,1.13329348475792
5648,2022,3,29,Peru,Paraguay,2,0,World Cup qualifier,,1856,1727,Peru-Paraguay,2-0,1856,1727,2-0,3583,129,1.0746960046323104
5649,2022,3,29,Ecuador,Argentina,1,1,World Cup qualifier,,1840,2108,Ecuador-Argentina,1-1,2108,1840,1-1,3948,268,1.1456521739130434
5650,2022,3,29,Chile,Uruguay,0,2,World Cup qualifier,,1767,1923,Chile-Uruguay,0-2,1923,1767,2-0,3690,156,1.0882852292020373
5651,2022,3,29,Bolivia,Brazil,0,3,World Cup qualifier,,1634,2155,Bolivia-Brazil,0-3,2155,1634,3-0,3789,521,1.3188494492044063
5653,2022,3,30,Panama,Canada,1,0,World Cup qualifier,,1629,1798,Panama-Canada,1-0,1798,1629,0-1,3427,169,1.1037446286065071
5656,2022,3,30,Costa Rica,United States,2,0,World Cup qualifier,,1743,1822,Costa Rica-United States,2-0,1822,1743,0-2,3565,79,1.0453241537578888
5697,2022,6,1,Poland,Wales,2,1,European Nations League A,,1816,1825,Poland-Wales,2-1,1825,1816,1-2,3641,9,1.0049559471365639
5698,2022,6,1,Scotland,Ukraine,1,3,World Cup qualifier,,1699,1848,Scotland-Ukraine,1-3,1848,1699,3-1,3547,149,1.0876986462625073
5699,2022,6,1,Argentina,Italy,3,0,Intercontinental Championship,EN,2138,1968,Argentina-Italy,3-0,2138,1968,3-0,4106,170,1.0863821138211383
5710,2022,6,2,Slovenia,Sweden,0,2,European Nations League B,,1603,1833,Slovenia-Sweden,0-2,1833,1603,2-0,3436,230,1.1434809731752964
5711,2022,6,2,Serbia,Norway,0,1,European Nations League B,,1816,1777,Serbia-Norway,0-1,1816,1777,0-1,3593,39,1.0219471018570625
5713,2022,6,2,Spain,Portugal,1,1,European Nations League A,,2031,1993,Spain-Portugal,1-1,2031,1993,1-1,4024,38,1.0190667335674861
5714,2022,6,2,Czechia,Switzerland,2,1,European Nations League A,,1842,1900,Czechia-Switzerland,2-1,1900,1842,1-2,3742,58,1.0314875135722041
5720,2022,6,2,Panama,Costa Rica,2,0,CONCACAF Nations League A,,1647,1711,Panama-Costa Rica,2-0,1711,1647,0-2,3358,64,1.0388585306618094
5732,2022,6,3,France,Denmark,1,2,European Nations League A,,2083,1969,France-Denmark,1-2,2083,1969,1-2,4052,114,1.0578974098527172
5733,2022,6,3,Croatia,Austria,0,3,European Nations League A,,1799,1775,Croatia-Austria,0-3,1799,1775,0-3,3574,24,1.0135211267605633
5734,2022,6,3,Belgium,Netherlands,1,3,European Nations League A,,2014,1993,Belgium-Netherlands,1-3,2014,1993,1-3,4007,21,1.0105368790767686
5753,2022,6,4,Finland,Bosnia and Herzegovina,1,1,European Nations League B,,1689,1600,Finland-Bosnia and Herzegovina,1-1,1689,1600,1-1,3289,89,1.055625
5755,2022,6,4,Italy,Germany,1,1,European Nations League A,,1962,1973,Italy-Germany,1-1,1973,1962,1-1,3935,11,1.0056065239551477
5756,2022,6,4,Hungary,England,1,0,European Nations League A,,1758,2008,Hungary-England,1-0,2008,1758,0-1,3766,250,1.142207053469852
5776,2022,6,5,Sweden,Norway,1,2,European Nations League B,,1805,1805,Sweden-Norway,1-2,1805,1805,1-2,3610,0,1.0
5778,2022,6,5,Portugal,Switzerland,4,0,European Nations League A,,2012,1881,Portugal-Switzerland,4-0,2012,1881,4-0,3893,131,1.0696438064859117
5779,2022,6,5,Czechia,Spain,2,2,European Nations League A,,1847,2026,Czechia-Spain,2-2,2026,1847,2-2,3873,179,1.0969139144558744
5780,2022,6,5,Wales,Ukraine,1,0,World Cup qualifier,,1841,1832,Wales-Ukraine,1-0,1841,1832,1-0,3673,9,1.0049126637554586
5795,2022,6,6,Croatia,France,1,1,European Nations League A,,1809,2073,Croatia-France,1-1,2073,1809,1-1,3882,264,1.1459369817578773
5796,2022,6,6,Austria,Denmark,1,2,European Nations League A,,1760,1984,Austria-Denmark,1-2,1984,1760,2-1,3744,224,1.1272727272727272
5811,2022,6,7,Bosnia and Herzegovina,Romania,1,0,European Nations League B,,1616,1606,Bosnia and Herzegovina-Romania,1-0,1616,1606,1-0,3222,10,1.0062266500622665
5812,2022,6,7,Italy,Hungary,2,1,European Nations League A,,1968,1752,Italy-Hungary,2-1,1968,1752,2-1,3720,216,1.1232876712328768
5813,2022,6,7,Germany,England,1,1,European Nations League A,,1969,2012,Germany-England,1-1,2012,1969,1-1,3981,43,1.0218384966988319
5838,2022,6,8,Ireland,Ukraine,0,1,European Nations League B,,1649,1848,Ireland-Ukraine,0-1,1848,1649,1-0,3497,199,1.1206791995148575
5839,2022,6,8,Wales,Netherlands,1,2,European Nations League A,,1824,2010,Wales-Netherlands,1-2,2010,1824,2-1,3834,186,1.1019736842105263
5840,2022,6,8,Belgium,Poland,4,1,European Nations League A,,2026,1804,Belgium-Poland,4-1,2026,1804,4-1,3830,222,1.123059866962306
5853,2022,6,9,North Macedonia,Georgia,0,3,European Nations League C,,1613,1658,North Macedonia-Georgia,0-3,1658,1613,3-0,3271,45,1.027898326100434
5857,2022,6,9,Sweden,Serbia,0,1,European Nations League B,,1781,1850,Sweden-Serbia,0-1,1850,1781,1-0,3631,69,1.038742279618192
5858,2022,6,9,Norway,Slovenia,0,0,European Nations League B,,1791,1607,Norway-Slovenia,0-0,1791,1607,0-0,3398,184,1.1144990665836962
5859,2022,6,9,Switzerland,Spain,0,1,European Nations League A,,1864,2043,Switzerland-Spain,0-1,2043,1864,1-0,3907,179,1.0960300429184548
5860,2022,6,9,Portugal,Czechia,2,0,European Nations League A,,2023,1836,Portugal-Czechia,2-0,2023,1836,2-0,3859,187,1.1018518518518519
5877,2022,6,10,Denmark,Croatia,0,1,European Nations League A,,1951,1842,Denmark-Croatia,0-1,1951,1842,0-1,3793,109,1.0591748099891423
5878,2022,6,10,Austria,France,1,1,European Nations League A,,1771,2062,Austria-France,1-1,2062,1771,1-1,3833,291,1.1643139469226427
5898,2022,6,11,Romania,Finland,1,0,European Nations League B,,1626,1681,Romania-Finland,1-0,1681,1626,0-1,3307,55,1.0338253382533826
5900,2022,6,11,Ireland,Scotland,3,0,European Nations League B,,1680,1678,Ireland-Scotland,3-0,1680,1678,3-0,3358,2,1.0011918951132301
5901,2022,6,11,Wales,Belgium,1,1,European Nations League A,,1830,2020,Wales-Belgium,1-1,2020,1830,1-1,3850,190,1.1038251366120218
5902,2022,6,11,Netherlands,Poland,2,2,European Nations League A,,1996,1818,Netherlands-Poland,2-2,1996,1818,2-2,3814,178,1.0979097909790978
5903,2022,6,11,Hungary,Germany,1,1,European Nations League A,,1758,1963,Hungary-Germany,1-1,1963,1758,1-1,3721,205,1.1166097838452786
5904,2022,6,11,England,Italy,0,0,European Nations League A,,2004,1976,England-Italy,0-0,2004,1976,0-0,3980,28,1.01417004048583
5918,2022,6,12,Slovenia,Serbia,2,2,European Nations League B,,1615,1842,Slovenia-Serbia,2-2,1842,1615,2-2,3457,227,1.1405572755417956
5919,2022,6,12,Norway,Sweden,3,2,European Nations League B,,1805,1767,Norway-Sweden,3-2,1805,1767,3-2,3572,38,1.021505376344086
5920,2022,6,12,Switzerland,Portugal,1,0,European Nations League A,,1887,2000,Switzerland-Portugal,1-0,2000,1887,0-1,3887,113,1.0598834128245893
5921,2022,6,12,Spain,Czechia,2,0,European Nations League A,,2052,1827,Spain-Czechia,2-0,2052,1827,2-0,3879,225,1.1231527093596059
5935,2022,6,13,France,Croatia,0,1,European Nations League A,,2027,1877,France-Croatia,0-1,2027,1877,0-1,3904,150,1.079914757591902
5936,2022,6,13,Denmark,Austria,2,0,European Nations League A,,1961,1761,Denmark-Austria,2-0,1961,1761,2-0,3722,200,1.1135718341851222
5937,2022,6,13,Australia,Peru,0,0,World Cup qualifier,QA,1703,1850,Australia-Peru,0-0,1850,1703,0-0,3553,147,1.086318261890781
5962,2022,6,14,Ireland,Ukraine,1,1,European Nations League B,PL,1689,1848,Ireland-Ukraine,1-1,1848,1689,1-1,3537,159,1.0941385435168738
5963,2022,6,14,Bosnia and Herzegovina,Finland,3,2,European Nations League B,,1635,1663,Bosnia and Herzegovina-Finland,3-2,1663,1635,2-3,3298,28,1.0171253822629969
5965,2022,6,14,Poland,Belgium,0,1,European Nations League A,,1804,2034,Poland-Belgium,0-1,2034,1804,1-0,3838,230,1.1274944567627494
5966,2022,6,14,Netherlands,Wales,3,2,European Nations League A,,2003,1823,Netherlands-Wales,3-2,2003,1823,3-2,3826,180,1.0987383433900164
5967,2022,6,14,Germany,Italy,4,2,European Nations League A,,1989,1950,Germany-Italy,4-2,1989,1950,4-2,3939,39,1.02
5968,2022,6,14,England,Hungary,0,3,European Nations League A,,1938,1824,England-Hungary,0-3,1938,1824,0-3,3762,114,1.0625
6005,2022,7,27,Japan,South Korea,3,0,East Asian Championship,,1780,1783,Japan-South Korea,3-0,1783,1780,0-3,3563,3,1.0016853932584269
6017,2022,9,21,Scotland,Ukraine,3,0,European Nations League B,,1745,1809,Scotland-Ukraine,3-0,1809,1745,0-3,3554,64,1.036676217765043
6031,2022,9,22,Poland,Netherlands,0,2,European Nations League A,,1782,2025,Poland-Netherlands,0-2,2025,1782,2-0,3807,243,1.1363636363636365
6032,2022,9,22,France,Austria,2,0,European Nations League A,,2034,1754,France-Austria,2-0,2034,1754,2-0,3788,280,1.1596351197263397
6033,2022,9,22,Croatia,Denmark,2,1,European Nations League A,,1896,1942,Croatia-Denmark,2-1,1942,1896,1-2,3838,46,1.0242616033755274
6034,2022,9,22,Belgium,Wales,2,1,European Nations League A,,2040,1817,Belgium-Wales,2-1,2040,1817,2-1,3857,223,1.1227297743533298
6059,2022,9,23,Italy,England,1,0,European Nations League A,,1964,1924,Italy-England,1-0,1964,1924,1-0,3888,40,1.0207900207900207
6060,2022,9,23,Germany,Hungary,0,1,European Nations League A,,1956,1857,Germany-Hungary,0-1,1956,1857,0-1,3813,99,1.0533117932148628
6080,2022,9,24,Slovenia,Norway,2,1,European Nations League B,,1640,1780,Slovenia-Norway,2-1,1780,1640,1-2,3420,140,1.0853658536585367
6081,2022,9,24,Serbia,Sweden,4,1,European Nations League B,,1861,1748,Serbia-Sweden,4-1,1861,1748,4-1,3609,113,1.0646453089244852
6082,2022,9,24,Scotland,Ireland,2,1,European Nations League B,,1757,1677,Scotland-Ireland,2-1,1757,1677,2-1,3434,80,1.0477042337507454
6085,2022,9,24,Spain,Switzerland,1,2,European Nations League A,,2019,1920,Spain-Switzerland,1-2,2019,1920,1-2,3939,99,1.0515625
6086,2022,9,24,Czechia,Portugal,0,3,European Nations League A,,1797,2030,Czechia-Portugal,0-3,2030,1797,3-0,3827,233,1.1296605453533668
6097,2022,9,25,Wales,Poland,0,1,European Nations League A,,1790,1809,Wales-Poland,0-1,1809,1790,1-0,3599,19,1.0106145251396648
6098,2022,9,25,Netherlands,Belgium,1,0,European Nations League A,,2040,2025,Netherlands-Belgium,1-0,2040,2025,1-0,4065,15,1.0074074074074073
6099,2022,9,25,Denmark,France,2,0,European Nations League A,,1971,2005,Denmark-France,2-0,2005,1971,0-2,3976,34,1.017250126839168
6100,2022,9,25,Austria,Croatia,1,3,European Nations League A,,1728,1922,Austria-Croatia,1-3,1922,1728,3-1,3650,194,1.1122685185185186
6108,2022,9,26,Romania,Bosnia and Herzegovina,4,1,European Nations League B,,1615,1616,Romania-Bosnia and Herzegovina,4-1,1616,1615,1-4,3231,1,1.0006191950464396
6110,2022,9,26,Hungary,Italy,0,2,European Nations League A,,1828,1993,Hungary-Italy,0-2,1993,1828,2-0,3821,165,1.0902625820568927
6111,2022,9,26,England,Germany,3,3,European Nations League A,,1920,1960,England-Germany,3-3,1960,1920,3-3,3880,40,1.0208333333333333
6146,2022,9,27,Sweden,Slovenia,1,1,European Nations League B,,1737,1651,Sweden-Slovenia,1-1,1737,1651,1-1,3388,86,1.0520896426408237
6147,2022,9,27,Scotland,Ukraine,0,0,European Nations League B,PL,1761,1822,Scotland-Ukraine,0-0,1822,1761,0-0,3583,61,1.0346394094264622
6148,2022,9,27,Norway,Serbia,0,2,European Nations League B,,1748,1893,Norway-Serbia,0-2,1893,1748,2-0,3641,145,1.0829519450800915
6151,2022,9,27,Switzerland,Czechia,2,1,European Nations League A,,1929,1788,Switzerland-Czechia,2-1,1929,1788,2-1,3717,141,1.0788590604026846
6152,2022,9,27,Portugal,Spain,0,1,European Nations League A,,2004,2045,Portugal-Spain,0-1,2045,2004,1-0,4049,41,1.0204590818363273
6428,2023,3,23,Italy,England,1,2,European Championship qualifier,,1948,1993,Italy-England,1-2,1993,1948,2-1,3941,45,1.023100616016427
6429,2023,3,23,Denmark,Finland,3,1,European Championship qualifier,,1891,1653,Denmark-Finland,3-1,1891,1653,3-1,3544,238,1.1439806412583182
6457,2023,3,24,Sweden,Belgium,0,3,European Championship qualifier,,1747,1976,Sweden-Belgium,0-3,1976,1747,3-0,3723,229,1.1310818546078993
6461,2023,3,24,France,Netherlands,4,0,European Championship qualifier,,2108,2047,France-Netherlands,4-0,2108,2047,4-0,4155,61,1.029799706888129
6462,2023,3,24,Czechia,Poland,3,1,European Championship qualifier,,1802,1779,Czechia-Poland,3-1,1802,1779,3-1,3581,23,1.012928611579539
6480,2023,3,25,Spain,Norway,3,0,European Championship qualifier,,2005,1745,Spain-Norway,3-0,2005,1745,3-0,3750,260,1.148997134670487
6484,2023,3,25,Croatia,Wales,1,1,European Championship qualifier,,1936,1732,Croatia-Wales,1-1,1936,1732,1-1,3668,204,1.117782909930716
6506,2023,3,26,England,Ukraine,2,0,European Championship qualifier,,2003,1812,England-Ukraine,2-0,2003,1812,2-0,3815,191,1.1054083885209713
6527,2023,3,27,Ireland,France,0,1,European Championship qualifier,,1672,2113,Ireland-France,0-1,2113,1672,1-0,3785,441,1.263755980861244
6569,2023,3,28,Turkey,Croatia,0,2,European Championship qualifier,,1702,1957,Turkey-Croatia,0-2,1957,1702,2-0,3659,255,1.1498237367802586
6570,2023,3,28,Switzerland,Israel,3,0,European Championship qualifier,,1891,1602,Switzerland-Israel,3-0,1891,1602,3-0,3493,289,1.1803995006242198
6571,2023,3,28,Scotland,Spain,2,0,European Championship qualifier,,1798,1963,Scotland-Spain,2-0,1963,1798,0-2,3761,165,1.0917686318131257
6574,2023,3,28,Georgia,Norway,1,1,European Championship qualifier,,1652,1745,Georgia-Norway,1-1,1745,1652,1-1,3397,93,1.0562953995157385
6579,2023,3,28,Costa Rica,Panama,0,1,CONCACAF Nations League A,,1715,1671,Costa Rica-Panama,0-1,1715,1671,0-1,3386,44,1.0263315380011968
6621,2023,6,14,Netherlands,Croatia,2,3,European Nations League,,1991,2013,Netherlands-Croatia,2-3,2013,1991,3-2,4004,22,1.011049723756906
6633,2023,6,15,Spain,Italy,2,1,European Nations League,NL,1987,1926,Spain-Italy,2-1,1987,1926,2-1,3913,61,1.0316718587746625
6634,2023,6,15,United States,Mexico,3,0,CONCACAF Nations League,,1835,1778,United States-Mexico,3-0,1835,1778,3-0,3613,57,1.032058492688414
6635,2023,6,15,Canada,Panama,2,0,CONCACAF Nations League,US,1758,1647,Canada-Panama,2-0,1758,1647,2-0,3405,111,1.0673952641165756
6653,2023,6,16,Greece,Ireland,2,1,European Championship qualifier,,1697,1658,Greece-Ireland,2-1,1697,1658,2-1,3355,39,1.023522316043426
6655,2023,6,16,Finland,Slovenia,2,0,European Championship qualifier,,1694,1656,Finland-Slovenia,2-0,1694,1656,2-0,3350,38,1.0229468599033817
6673,2023,6,17,Portugal,Bosnia and Herzegovina,3,0,European Championship qualifier,,2009,1603,Portugal-Bosnia and Herzegovina,3-0,2009,1603,3-0,3612,406,1.2532751091703056
6674,2023,6,17,Norway,Scotland,1,2,European Championship qualifier,,1722,1821,Norway-Scotland,1-2,1821,1722,2-1,3543,99,1.0574912891986064
6681,2023,6,17,Belgium,Austria,1,1,European Championship qualifier,,1973,1774,Belgium-Austria,1-1,1973,1774,1-1,3747,199,1.1121758737316798
6702,2023,6,18,Netherlands,Italy,2,3,European Nations League,,1955,1962,Netherlands-Italy,2-3,1962,1955,3-2,3917,7,1.0035805626598466
6703,2023,6,18,Croatia,Spain,0,0,European Nations League,NL,2011,1989,Croatia-Spain,0-0,2011,1989,0-0,4000,22,1.0110608345902463
6704,2023,6,18,Mexico,Panama,1,0,CONCACAF Nations League,US,1791,1634,Mexico-Panama,1-0,1791,1634,1-0,3425,157,1.0960832313341493
6705,2023,6,18,United States,Canada,2,0,CONCACAF Nations League,,1851,1742,United States-Canada,2-0,1851,1742,2-0,3593,109,1.0625717566016073
6713,2023,6,19,Turkey,Wales,2,0,European Championship qualifier,,1729,1661,Turkey-Wales,2-0,1729,1661,2-0,3390,68,1.040939193257074
6714,2023,6,19,Switzerland,Romania,2,2,European Championship qualifier,,1876,1636,Switzerland-Romania,2-2,1876,1636,2-2,3512,240,1.1466992665036675
6715,2023,6,19,Slovenia,Denmark,1,1,European Championship qualifier,,1662,1851,Slovenia-Denmark,1-1,1851,1662,1-1,3513,189,1.1137184115523466
6719,2023,6,19,France,Greece,1,0,European Championship qualifier,,2115,1695,France-Greece,1-0,2115,1695,1-0,3810,420,1.247787610619469
6738,2023,6,20,Uzbekistan,Iran,0,1,Central Asian Nations Cup,,1607,1801,Uzbekistan-Iran,0-1,1801,1607,1-0,3408,194,1.120721841941506
6742,2023,6,20,Scotland,Georgia,2,0,European Championship qualifier,,1832,1651,Scotland-Georgia,2-0,1832,1651,2-0,3483,181,1.1096305269533615
6752,2023,6,20,Austria,Sweden,2,0,European Championship qualifier,,1794,1738,Austria-Sweden,2-0,1794,1738,2-0,3532,56,1.0322209436133487
6768,2023,6,26,Panama,Costa Rica,2,1,CONCACAF Championship,US,1663,1661,Panama-Costa Rica,2-1,1663,1661,2-1,3324,2,1.0012040939193256
6805,2023,7,8,Mexico,Costa Rica,2,0,CONCACAF Championship,US,1802,1638,Mexico-Costa Rica,2-0,1802,1638,2-0,3440,164,1.1001221001221002
6808,2023,7,9,United States,Canada,2,2,CONCACAF Championship,,1821,1725,United States-Canada,2-2,1821,1725,2-2,3546,96,1.0556521739130436
6819,2023,7,12,United States,Panama,1,1,CONCACAF Championship,,1807,1707,United States-Panama,1-1,1807,1707,1-1,3514,100,1.0585823081429409
6825,2023,7,16,Mexico,Panama,1,0,CONCACAF Championship,US,1840,1690,Mexico-Panama,1-0,1840,1690,1-0,3530,150,1.0887573964497042
6865,2023,9,7,Serbia,Hungary,1,2,European Championship qualifier,,1827,1849,Serbia-Hungary,1-2,1849,1827,2-1,3676,22,1.0120415982484947
6867,2023,9,7,Netherlands,Greece,3,0,European Championship qualifier,,1963,1687,Netherlands-Greece,3-0,1963,1687,3-0,3650,276,1.163604030823948
6870,2023,9,7,France,Ireland,2,0,European Championship qualifier,,2117,1657,France-Ireland,2-0,2117,1657,2-0,3774,460,1.2776101388050694
6880,2023,9,7,Paraguay,Peru,0,0,World Cup qualifier,,1720,1842,Paraguay-Peru,0-0,1842,1720,0-0,3562,122,1.0709302325581396
6881,2023,9,7,Colombia,Venezuela,1,0,World Cup qualifier,,1956,1694,Colombia-Venezuela,1-0,1956,1694,1-0,3650,262,1.154663518299882
6882,2023,9,7,Argentina,Ecuador,1,0,World Cup qualifier,,2151,1849,Argentina-Ecuador,1-0,2151,1849,1-0,4000,302,1.163331530557058
6892,2023,9,8,Slovakia,Portugal,0,1,European Championship qualifier,,1613,2019,Slovakia-Portugal,0-1,2019,1613,1-0,3632,406,1.2517048977061376
6894,2023,9,8,Georgia,Spain,1,3,European Championship qualifier,,1634,2006,Georgia-Spain,1-3,2006,1634,3-1,3640,372,1.2276621787025703
6905,2023,9,8,Uruguay,Chile,3,1,World Cup qualifier,,1926,1698,Uruguay-Chile,3-1,1926,1698,3-1,3624,228,1.1342756183745584
6906,2023,9,8,Brazil,Bolivia,4,1,World Cup qualifier,,2096,1602,Brazil-Bolivia,4-1,2096,1602,4-1,3698,494,1.3083645443196006
6919,2023,9,9,Romania,Israel,1,1,European Championship qualifier,,1629,1620,Romania-Israel,1-1,1629,1620,1-1,3249,9,1.0055555555555555
6923,2023,9,9,England,Ukraine,1,1,European Championship qualifier,PL,1999,1840,England-Ukraine,1-1,1999,1840,1-1,3839,159,1.0864130434782608
6939,2023,9,10,Ireland,Netherlands,1,2,European Championship qualifier,,1648,1972,Ireland-Netherlands,1-2,1972,1648,2-1,3620,324,1.1966019417475728
6941,2023,9,10,Finland,Denmark,0,1,European Championship qualifier,,1689,1868,Finland-Denmark,0-1,1868,1689,1-0,3557,179,1.1059798697454115
6943,2023,9,10,Albania,Poland,2,0,European Championship qualifier,,1615,1724,Albania-Poland,2-0,1724,1615,0-2,3339,109,1.0674922600619194
6987,2023,9,12,Sweden,Austria,1,3,European Championship qualifier,,1722,1821,Sweden-Austria,1-3,1821,1722,3-1,3543,99,1.0574912891986064
6990,2023,9,12,Norway,Georgia,2,1,European Championship qualifier,,1745,1624,Norway-Georgia,2-1,1745,1624,2-1,3369,121,1.0745073891625616
6992,2023,9,12,Italy,Ukraine,2,1,European Championship qualifier,,1956,1831,Italy-Ukraine,2-1,1956,1831,2-1,3787,125,1.0682687056253413
7003,2023,9,12,Venezuela,Paraguay,1,0,World Cup qualifier,,1710,1704,Venezuela-Paraguay,1-0,1710,1704,1-0,3414,6,1.0035211267605635
7004,2023,9,12,Peru,Brazil,0,1,World Cup qualifier,,1830,2108,Peru-Brazil,0-1,2108,1830,1-0,3938,278,1.151912568306011
7005,2023,9,12,Ecuador,Uruguay,2,1,World Cup qualifier,,1868,1907,Ecuador-Uruguay,2-1,1907,1868,1-2,3775,39,1.0208779443254818
7006,2023,9,12,Chile,Colombia,0,0,World Cup qualifier,,1707,1947,Chile-Colombia,0-0,1947,1707,0-0,3654,240,1.140597539543058
7033,2023,10,12,Spain,Scotland,2,0,European Championship qualifier,,2017,1817,Spain-Scotland,2-0,2017,1817,2-0,3834,200,1.1100715465052284
7037,2023,10,12,Croatia,Turkey,0,1,European Championship qualifier,,1979,1743,Croatia-Turkey,0-1,1979,1743,0-1,3722,236,1.1353987378083763
7040,2023,10,12,Albania,Czechia,3,0,European Championship qualifier,,1658,1749,Albania-Czechia,3-0,1749,1658,0-3,3407,91,1.054885404101327
7048,2023,10,12,Colombia,Uruguay,2,2,World Cup qualifier,,1939,1915,Colombia-Uruguay,2-2,1939,1915,2-2,3854,24,1.012532637075718
7049,2023,10,12,Chile,Peru,2,0,World Cup qualifier,,1739,1798,Chile-Peru,2-0,1798,1739,0-2,3537,59,1.0339275445658425
7050,2023,10,12,Brazil,Venezuela,1,1,World Cup qualifier,,2090,1728,Brazil-Venezuela,1-1,2090,1728,1-1,3818,362,1.2094907407407407
7052,2023,10,12,Argentina,Paraguay,1,0,World Cup qualifier,,2158,1702,Argentina-Paraguay,1-0,2158,1702,1-0,3860,456,1.2679200940070505
7067,2023,10,13,Portugal,Slovakia,3,2,European Championship qualifier,,2024,1612,Portugal-Slovakia,3-2,2024,1612,3-2,3636,412,1.2555831265508686
7068,2023,10,13,Netherlands,France,1,2,European Championship qualifier,,1954,2121,Netherlands-France,1-2,2121,1954,2-1,4075,167,1.0854657113613102
7070,2023,10,13,Ireland,Greece,0,2,European Championship qualifier,,1613,1723,Ireland-Greece,0-2,1723,1613,2-0,3336,110,1.0681959082455053
7073,2023,10,13,Austria,Belgium,2,3,European Championship qualifier,,1805,1999,Austria-Belgium,2-3,1999,1805,3-2,3804,194,1.1074792243767313
7091,2023,10,14,Slovenia,Finland,3,0,European Championship qualifier,,1700,1662,Slovenia-Finland,3-0,1700,1662,3-0,3362,38,1.022864019253911
7094,2023,10,14,Hungary,Serbia,2,1,European Championship qualifier,,1859,1817,Hungary-Serbia,2-1,1859,1817,2-1,3676,42,1.023115024766098
7102,2023,10,15,Wales,Croatia,2,1,European Championship qualifier,,1706,1948,Wales-Croatia,2-1,1948,1706,1-2,3654,242,1.141852286049238
7107,2023,10,15,Norway,Spain,0,1,European Championship qualifier,,1745,2028,Norway-Spain,0-1,2028,1745,1-0,3773,283,1.1621776504297994
7123,2023,10,16,Greece,Netherlands,0,1,European Championship qualifier,,1710,1967,Greece-Netherlands,0-1,1967,1710,1-0,3677,257,1.1502923976608188
7126,2023,10,16,Belgium,Sweden,1,1,European Championship qualifier,,1983,1740,Belgium-Sweden,1-1,1983,1740,1-1,3723,243,1.139655172413793
7176,2023,10,17,England,Italy,3,1,European Championship qualifier,,2031,1940,England-Italy,3-1,2031,1940,3-1,3971,91,1.0469072164948454
7184,2023,10,17,Venezuela,Chile,3,0,World Cup qualifier,,1754,1713,Venezuela-Chile,3-0,1754,1713,3-0,3467,41,1.0239346176298891
7185,2023,10,17,Uruguay,Brazil,2,0,World Cup qualifier,,1951,2054,Uruguay-Brazil,2-0,2054,1951,0-2,4005,103,1.052793439261917
7186,2023,10,17,Peru,Argentina,0,2,World Cup qualifier,,1787,2169,Peru-Argentina,0-2,2169,1787,2-0,3956,382,1.2137660884163401
7188,2023,10,17,Ecuador,Colombia,0,0,World Cup qualifier,,1877,1941,Ecuador-Colombia,0-0,1941,1877,0-0,3818,64,1.0340969632392114
7199,2023,11,15,Israel,Switzerland,1,1,European Championship qualifier,HU,1616,1833,Israel-Switzerland,1-1,1833,1616,1-1,3449,217,1.1342821782178218
7232,2023,11,16,Georgia,Scotland,2,2,European Championship qualifier,,1641,1810,Georgia-Scotland,2-2,1810,1641,2-2,3451,169,1.1029859841560024
7241,2023,11,16,Venezuela,Ecuador,0,0,World Cup qualifier,,1755,1876,Venezuela-Ecuador,0-0,1876,1755,0-0,3631,121,1.0689458689458688
7244,2023,11,16,Colombia,Brazil,2,1,World Cup qualifier,,1962,2033,Colombia-Brazil,2-1,2033,1962,1-2,3995,71,1.0361875637104996
7245,2023,11,16,Chile,Paraguay,0,0,World Cup qualifier,,1707,1717,Chile-Paraguay,0-0,1717,1707,0-0,3424,10,1.005858230814294
7246,2023,11,16,Bolivia,Peru,2,0,World Cup qualifier,,1616,1748,Bolivia-Peru,2-0,1748,1616,0-2,3364,132,1.0816831683168318
7247,2023,11,16,Argentina,Uruguay,0,2,World Cup qualifier,,2117,2003,Argentina-Uruguay,0-2,2117,2003,0-2,4120,114,1.0569146280579131
7261,2023,11,17,Poland,Czechia,1,1,European Championship qualifier,,1708,1754,Poland-Czechia,1-1,1754,1708,1-1,3462,46,1.0269320843091334
7267,2023,11,17,Denmark,Slovenia,2,1,European Championship qualifier,,1878,1705,Denmark-Slovenia,2-1,1878,1705,2-1,3583,173,1.1014662756598241
7281,2023,11,18,Netherlands,Ireland,1,0,European Championship qualifier,,1970,1613,Netherlands-Ireland,1-0,1970,1613,1-0,3583,357,1.2213267203967761
7296,2023,11,19,Spain,Georgia,3,1,European Championship qualifier,,2033,1638,Spain-Georgia,3-1,2033,1638,3-1,3671,395,1.2411477411477412
7298,2023,11,19,Scotland,Norway,3,3,European Championship qualifier,,1801,1755,Scotland-Norway,3-3,1801,1755,3-3,3556,46,1.0262108262108263
7320,2023,11,20,Italy,Ukraine,0,0,European Championship qualifier,DE,1938,1850,Italy-Ukraine,0-0,1938,1850,0-0,3788,88,1.0475675675675675
7349,2023,11,21,Uzbekistan,Iran,2,2,World Cup and Asian Cup qualifier,,1638,1826,Uzbekistan-Iran,2-2,1826,1638,2-2,3464,188,1.1147741147741148
7366,2023,11,21,Wales,Turkey,1,1,European Championship qualifier,,1696,1766,Wales-Turkey,1-1,1766,1696,1-1,3462,70,1.0412735849056605
7367,2023,11,21,Romania,Switzerland,1,0,European Championship qualifier,,1674,1792,Romania-Switzerland,1-0,1792,1674,0-1,3466,118,1.070489844683393
7369,2023,11,21,Greece,France,2,2,European Championship qualifier,,1729,2110,Greece-France,2-2,2110,1729,2-2,3839,381,1.2203585887796413
7380,2023,11,21,Canada,Jamaica,2,3,CONCACAF Nations League A,,1706,1618,Canada-Jamaica,2-3,1706,1618,2-3,3324,88,1.0543881334981458
7381,2023,11,21,Uruguay,Bolivia,3,0,World Cup qualifier,,2007,1612,Uruguay-Bolivia,3-0,2007,1612,3-0,3619,395,1.2450372208436724
7382,2023,11,21,Peru,Venezuela,1,1,World Cup qualifier,,1743,1760,Peru-Venezuela,1-1,1760,1743,1-1,3503,17,1.0097532989099254
7383,2023,11,21,Paraguay,Colombia,0,1,World Cup qualifier,,1705,1974,Paraguay-Colombia,0-1,1974,1705,1-0,3679,269,1.1577712609970674
7384,2023,11,21,Ecuador,Chile,1,0,World Cup qualifier,,1883,1700,Ecuador-Chile,1-0,1883,1700,1-0,3583,183,1.1076470588235294
7385,2023,11,21,Brazil,Argentina,0,1,World Cup qualifier,,2012,2138,Brazil-Argentina,0-1,2138,2012,1-0,4150,126,1.062624254473161
7479,2024,1,18,Ivory Coast,Nigeria,0,1,African Nations Cup,,1618,1603,Ivory Coast-Nigeria,0-1,1618,1603,0-1,3221,15,1.0093574547723019
7483,2024,1,19,Iraq,Japan,2,1,Asian Cup,QA,1666,1870,Iraq-Japan,2-1,1870,1666,1-2,3536,204,1.1224489795918366
7491,2024,1,20,Mali,Tunisia,1,1,African Nations Cup,CI,1648,1688,Mali-Tunisia,1-1,1688,1648,1-1,3336,40,1.0242718446601942
7509,2024,1,23,Australia,Uzbekistan,1,1,Asian Cup,QA,1785,1651,Australia-Uzbekistan,1-1,1785,1651,1-1,3436,134,1.0811629315566322
7535,2024,1,30,Saudi Arabia,South Korea,1,1,Asian Cup,QA,1615,1760,Saudi Arabia-South Korea,1-1,1760,1615,1-1,3375,145,1.089783281733746
7540,2024,2,2,South Korea,Australia,2,1,Asian Cup,QA,1787,1763,South Korea-Australia,2-1,1787,1763,2-1,3550,24,1.0136131593874078
7546,2024,2,3,Iran,Japan,2,1,Asian Cup,QA,1852,1850,Iran-Japan,2-1,1852,1850,2-1,3702,2,1.001081081081081
7549,2024,2,6,Jordan,South Korea,2,0,Asian Cup,QA,1627,1729,Jordan-South Korea,2-0,1729,1627,0-2,3356,102,1.0626920712968655
7550,2024,2,7,Qatar,Iran,3,2,Asian Cup,,1600,1815,Qatar-Iran,3-2,1815,1600,2-3,3415,215,1.134375
7555,2024,2,11,Ivory Coast,Nigeria,2,1,African Nations Cup,,1620,1638,Ivory Coast-Nigeria,2-1,1638,1620,1-2,3258,18,1.011111111111111
7601,2024,3,21,Wales,Finland,4,1,European Championship qualifier,,1716,1621,Wales-Finland,4-1,1716,1621,4-1,3337,95,1.0586057988895743
7607,2024,3,21,United States,Jamaica,3,1,CONCACAF Nations League,,1774,1611,United States-Jamaica,3-1,1774,1611,3-1,3385,163,1.101179391682185
7608,2024,3,21,Mexico,Panama,3,0,CONCACAF Nations League,US,1826,1734,Mexico-Panama,3-0,1826,1734,3-0,3560,92,1.0530565167243369
7662,2024,3,24,United States,Mexico,2,0,CONCACAF Nations League,,1800,1800,United States-Mexico,2-0,1800,1800,2-0,3600,0,1.0
7663,2024,3,24,Jamaica,Panama,1,0,CONCACAF Nations League,US,1638,1707,Jamaica-Panama,1-0,1707,1638,0-1,3345,69,1.0421245421245422
7721,2024,3,26,Wales,Poland,0,0,European Championship qualifier,,1710,1721,Wales-Poland,0-0,1721,1710,0-0,3431,11,1.0064327485380118
7723,2024,3,26,Georgia,Greece,0,0,European Championship qualifier,,1650,1740,Georgia-Greece,0-0,1740,1650,0-0,3390,90,1.0545454545454545
7921,2024,6,11,Iran,Uzbekistan,0,0,World Cup and Asian Cup qualifier,,1807,1680,Iran-Uzbekistan,0-0,1807,1680,0-0,3487,127,1.075595238095238
